network_config,strategy,strategy_params,neg_pos_ratio,pred_threshold,evidence_ratio,occ_thr,edge_thr,weight_thr,total_samples,positive_samples,negative_samples,negative_candidates_count,evaluated_days,skipped_days,tp,fp,tn,fn,precision,recall,f1_score,accuracy,selection_criteria
Baseline,MarginalProbability,{'prob_threshold': 0.05},1.0,0.3,0.2,3,2,0.3,243,123,120,12,29,24,36,0,120,87,1.0,0.2926829268292683,0.45283018867924524,0.6419753086419753,top_precision
Baseline,MarginalProbability,{'prob_threshold': 0.05},1.0,0.4,0.2,3,2,0.3,243,123,120,12,29,24,13,0,120,110,1.0,0.10569105691056911,0.1911764705882353,0.5473251028806584,top_precision
Baseline,MarginalProbability,{'prob_threshold': 0.1},1.0,0.3,0.2,3,2,0.3,246,123,123,25,29,24,36,0,123,87,1.0,0.2926829268292683,0.45283018867924524,0.6463414634146342,top_precision
Baseline,MarginalProbability,{'prob_threshold': 0.1},1.0,0.4,0.2,3,2,0.3,246,123,123,25,29,24,13,0,123,110,1.0,0.10569105691056911,0.1911764705882353,0.5528455284552846,top_precision
Baseline,MarginalProbability,{'prob_threshold': 0.15},1.0,0.3,0.2,3,2,0.3,246,123,123,32,29,24,36,0,123,87,1.0,0.2926829268292683,0.45283018867924524,0.6463414634146342,top_precision
Baseline,MarginalProbability,{'prob_threshold': 0.15},1.0,0.4,0.2,3,2,0.3,246,123,123,32,29,24,13,0,123,110,1.0,0.10569105691056911,0.1911764705882353,0.5528455284552846,top_precision
Baseline,FloodFrequency,{'max_flood_count': 3},1.0,0.2,0.7,3,2,0.3,110,62,48,2,29,24,31,0,48,31,1.0,0.5,0.6666666666666666,0.7181818181818181,top_precision
Baseline,FloodFrequency,{'max_flood_count': 3},1.0,0.3,0.2,3,2,0.3,173,123,50,2,29,24,36,0,50,87,1.0,0.2926829268292683,0.45283018867924524,0.49710982658959535,top_precision
Baseline,FloodFrequency,{'max_flood_count': 3},1.0,0.3,0.3,3,2,0.3,163,113,50,2,29,24,35,0,50,78,1.0,0.30973451327433627,0.4729729729729729,0.5214723926380368,top_precision
Baseline,FloodFrequency,{'max_flood_count': 3},1.0,0.3,0.5,3,2,0.3,134,84,50,2,29,24,33,0,50,51,1.0,0.39285714285714285,0.5641025641025641,0.6194029850746269,top_precision
Conservative,MarginalProbability,{'prob_threshold': 0.05},1.0,0.1,0.7,2,1,0.2,126,63,63,24,29,24,63,32,31,0,0.6631578947368421,1.0,0.7974683544303798,0.746031746031746,top_recall
Conservative,MarginalProbability,{'prob_threshold': 0.05},2.0,0.1,0.7,2,1,0.2,189,63,126,24,29,24,63,83,43,0,0.4315068493150685,1.0,0.6028708133971292,0.5608465608465608,top_recall
Conservative,MarginalProbability,{'prob_threshold': 0.1},1.0,0.1,0.7,2,1,0.2,126,63,63,37,29,24,63,32,31,0,0.6631578947368421,1.0,0.7974683544303798,0.746031746031746,top_recall
Conservative,MarginalProbability,{'prob_threshold': 0.1},2.0,0.1,0.7,2,1,0.2,189,63,126,37,29,24,63,83,43,0,0.4315068493150685,1.0,0.6028708133971292,0.5608465608465608,top_recall
Conservative,MarginalProbability,{'prob_threshold': 0.15},1.0,0.1,0.7,2,1,0.2,126,63,63,44,29,24,63,32,31,0,0.6631578947368421,1.0,0.7974683544303798,0.746031746031746,top_recall
Conservative,MarginalProbability,{'prob_threshold': 0.15},2.0,0.1,0.7,2,1,0.2,189,63,126,44,29,24,63,83,43,0,0.4315068493150685,1.0,0.6028708133971292,0.5608465608465608,top_recall
Conservative,FloodFrequency,{'max_flood_count': 2},1.0,0.1,0.7,2,1,0.2,126,63,63,12,29,24,63,32,31,0,0.6631578947368421,1.0,0.7974683544303798,0.746031746031746,top_recall
Conservative,FloodFrequency,{'max_flood_count': 2},2.0,0.1,0.7,2,1,0.2,189,63,126,12,29,24,63,83,43,0,0.4315068493150685,1.0,0.6028708133971292,0.5608465608465608,top_recall
Conservative,FloodFrequency,{'max_flood_count': 3},1.0,0.1,0.7,2,1,0.2,126,63,63,14,29,24,63,32,31,0,0.6631578947368421,1.0,0.7974683544303798,0.746031746031746,top_recall
Conservative,FloodFrequency,{'max_flood_count': 3},2.0,0.1,0.7,2,1,0.2,189,63,126,14,29,24,63,83,43,0,0.4315068493150685,1.0,0.6028708133971292,0.5608465608465608,top_recall
Baseline,FloodFrequency,{'max_flood_count': 3},1.0,0.1,0.5,3,2,0.3,134,84,50,2,29,24,76,11,39,8,0.8735632183908046,0.9047619047619048,0.8888888888888888,0.8582089552238806,top_f1
Baseline,CombinedConservative,"{'prob_threshold': 0.15, 'max_flood_count': 3, 'max_recent_floods': 2}",1.0,0.1,0.5,3,2,0.3,134,84,50,2,29,24,76,11,39,8,0.8735632183908046,0.9047619047619048,0.8888888888888888,0.8582089552238806,top_f1
Baseline,FloodFrequency,{'max_flood_count': 3},2.0,0.1,0.5,3,2,0.3,142,84,58,2,29,24,76,12,46,8,0.8636363636363636,0.9047619047619048,0.8837209302325582,0.8591549295774648,top_f1
Baseline,CombinedConservative,"{'prob_threshold': 0.15, 'max_flood_count': 3, 'max_recent_floods': 2}",2.0,0.1,0.5,3,2,0.3,142,84,58,2,29,24,76,12,46,8,0.8636363636363636,0.9047619047619048,0.8837209302325582,0.8591549295774648,top_f1
Baseline,FloodFrequency,{'max_flood_count': 3},1.0,0.1,0.3,3,2,0.3,163,113,50,2,29,24,95,8,42,18,0.9223300970873787,0.8407079646017699,0.8796296296296297,0.8404907975460123,top_f1
Baseline,CombinedConservative,"{'prob_threshold': 0.15, 'max_flood_count': 3, 'max_recent_floods': 2}",1.0,0.1,0.3,3,2,0.3,163,113,50,2,29,24,95,8,42,18,0.9223300970873787,0.8407079646017699,0.8796296296296297,0.8404907975460123,top_f1
Baseline,FloodFrequency,{'max_flood_count': 3},2.0,0.1,0.3,3,2,0.3,171,113,58,2,29,24,95,9,49,18,0.9134615384615384,0.8407079646017699,0.8755760368663594,0.8421052631578947,top_f1
Baseline,CombinedConservative,"{'prob_threshold': 0.15, 'max_flood_count': 3, 'max_recent_floods': 2}",2.0,0.1,0.3,3,2,0.3,171,113,58,2,29,24,95,9,49,18,0.9134615384615384,0.8407079646017699,0.8755760368663594,0.8421052631578947,top_f1
Baseline,FloodFrequency,{'max_flood_count': 3},1.0,0.1,0.2,3,2,0.3,173,123,50,2,29,24,100,7,43,23,0.9345794392523364,0.8130081300813008,0.8695652173913043,0.8265895953757225,top_f1
Baseline,CombinedConservative,"{'prob_threshold': 0.15, 'max_flood_count': 3, 'max_recent_floods': 2}",1.0,0.1,0.2,3,2,0.3,173,123,50,2,29,24,100,7,43,23,0.9345794392523364,0.8130081300813008,0.8695652173913043,0.8265895953757225,top_f1
Conservative,MarginalProbability,{'prob_threshold': 0.05},1.0,0.1,0.2,2,1,0.2,260,130,130,24,29,24,120,43,87,10,0.7361963190184049,0.9230769230769231,0.8191126279863482,0.7961538461538461,high_precision
Conservative,MarginalProbability,{'prob_threshold': 0.05},1.0,0.2,0.2,2,1,0.2,260,130,130,24,29,24,71,18,112,59,0.797752808988764,0.5461538461538461,0.6484018264840182,0.7038461538461539,high_precision
Conservative,MarginalProbability,{'prob_threshold': 0.05},1.0,0.2,0.3,2,1,0.2,242,121,121,24,29,24,77,30,91,44,0.719626168224299,0.6363636363636364,0.6754385964912281,0.6942148760330579,high_precision
Conservative,MarginalProbability,{'prob_threshold': 0.05},1.0,0.3,0.2,2,1,0.2,260,130,130,24,29,24,43,10,120,87,0.8113207547169812,0.33076923076923076,0.4699453551912569,0.6269230769230769,high_precision
Conservative,MarginalProbability,{'prob_threshold': 0.05},1.0,0.3,0.3,2,1,0.2,242,121,121,24,29,24,57,24,97,64,0.7037037037037037,0.47107438016528924,0.5643564356435643,0.6363636363636364,high_precision
Conservative,MarginalProbability,{'prob_threshold': 0.05},1.0,0.4,0.2,2,1,0.2,260,130,130,24,29,24,23,5,125,107,0.8214285714285714,0.17692307692307693,0.2911392405063291,0.5692307692307692,high_precision
Conservative,MarginalProbability,{'prob_threshold': 0.05},1.0,0.5,0.2,2,1,0.2,260,130,130,24,29,24,8,3,127,122,0.7272727272727273,0.06153846153846154,0.11347517730496455,0.5192307692307693,high_precision
Conservative,MarginalProbability,{'prob_threshold': 0.05},2.0,0.3,0.2,2,1,0.2,383,130,253,24,29,24,43,16,237,87,0.7288135593220338,0.33076923076923076,0.455026455026455,0.7310704960835509,high_precision
Conservative,MarginalProbability,{'prob_threshold': 0.1},1.0,0.1,0.2,2,1,0.2,260,130,130,37,29,24,120,43,87,10,0.7361963190184049,0.9230769230769231,0.8191126279863482,0.7961538461538461,high_precision
Conservative,MarginalProbability,{'prob_threshold': 0.1},1.0,0.2,0.2,2,1,0.2,260,130,130,37,29,24,71,18,112,59,0.797752808988764,0.5461538461538461,0.6484018264840182,0.7038461538461539,high_precision
Conservative,MarginalProbability,{'prob_threshold': 0.1},1.0,0.2,0.3,2,1,0.2,242,121,121,37,29,24,77,30,91,44,0.719626168224299,0.6363636363636364,0.6754385964912281,0.6942148760330579,high_precision
Conservative,MarginalProbability,{'prob_threshold': 0.1},1.0,0.3,0.2,2,1,0.2,260,130,130,37,29,24,43,10,120,87,0.8113207547169812,0.33076923076923076,0.4699453551912569,0.6269230769230769,high_precision
Conservative,MarginalProbability,{'prob_threshold': 0.1},1.0,0.3,0.3,2,1,0.2,242,121,121,37,29,24,57,24,97,64,0.7037037037037037,0.47107438016528924,0.5643564356435643,0.6363636363636364,high_precision
Conservative,MarginalProbability,{'prob_threshold': 0.1},1.0,0.4,0.2,2,1,0.2,260,130,130,37,29,24,23,5,125,107,0.8214285714285714,0.17692307692307693,0.2911392405063291,0.5692307692307692,high_precision
Conservative,MarginalProbability,{'prob_threshold': 0.1},1.0,0.5,0.2,2,1,0.2,260,130,130,37,29,24,8,3,127,122,0.7272727272727273,0.06153846153846154,0.11347517730496455,0.5192307692307693,high_precision
Conservative,MarginalProbability,{'prob_threshold': 0.1},2.0,0.3,0.2,2,1,0.2,390,130,260,37,29,24,43,16,244,87,0.7288135593220338,0.33076923076923076,0.455026455026455,0.735897435897436,high_precision
Conservative,MarginalProbability,{'prob_threshold': 0.15},1.0,0.1,0.2,2,1,0.2,260,130,130,44,29,24,120,43,87,10,0.7361963190184049,0.9230769230769231,0.8191126279863482,0.7961538461538461,high_precision
Conservative,MarginalProbability,{'prob_threshold': 0.15},1.0,0.2,0.2,2,1,0.2,260,130,130,44,29,24,71,18,112,59,0.797752808988764,0.5461538461538461,0.6484018264840182,0.7038461538461539,high_precision
Conservative,MarginalProbability,{'prob_threshold': 0.15},1.0,0.2,0.3,2,1,0.2,242,121,121,44,29,24,77,30,91,44,0.719626168224299,0.6363636363636364,0.6754385964912281,0.6942148760330579,high_precision
Conservative,MarginalProbability,{'prob_threshold': 0.15},1.0,0.3,0.2,2,1,0.2,260,130,130,44,29,24,43,10,120,87,0.8113207547169812,0.33076923076923076,0.4699453551912569,0.6269230769230769,high_precision
Conservative,MarginalProbability,{'prob_threshold': 0.15},1.0,0.3,0.3,2,1,0.2,242,121,121,44,29,24,57,24,97,64,0.7037037037037037,0.47107438016528924,0.5643564356435643,0.6363636363636364,high_precision
Conservative,MarginalProbability,{'prob_threshold': 0.15},1.0,0.4,0.2,2,1,0.2,260,130,130,44,29,24,23,5,125,107,0.8214285714285714,0.17692307692307693,0.2911392405063291,0.5692307692307692,high_precision
Conservative,MarginalProbability,{'prob_threshold': 0.15},1.0,0.5,0.2,2,1,0.2,260,130,130,44,29,24,8,3,127,122,0.7272727272727273,0.06153846153846154,0.11347517730496455,0.5192307692307693,high_precision
Conservative,MarginalProbability,{'prob_threshold': 0.15},2.0,0.3,0.2,2,1,0.2,390,130,260,44,29,24,43,16,244,87,0.7288135593220338,0.33076923076923076,0.455026455026455,0.735897435897436,high_precision
Conservative,FloodFrequency,{'max_flood_count': 2},1.0,0.1,0.2,2,1,0.2,256,130,126,12,29,24,120,39,87,10,0.7547169811320755,0.9230769230769231,0.8304498269896194,0.80859375,high_precision
Conservative,FloodFrequency,{'max_flood_count': 2},1.0,0.2,0.2,2,1,0.2,256,130,126,12,29,24,71,15,111,59,0.8255813953488372,0.5461538461538461,0.6574074074074073,0.7109375,high_precision
Conservative,FloodFrequency,{'max_flood_count': 2},1.0,0.2,0.3,2,1,0.2,241,121,120,12,29,24,77,29,91,44,0.7264150943396226,0.6363636363636364,0.6784140969162996,0.6970954356846473,high_precision
Conservative,FloodFrequency,{'max_flood_count': 2},1.0,0.3,0.2,2,1,0.2,256,130,126,12,29,24,43,10,116,87,0.8113207547169812,0.33076923076923076,0.4699453551912569,0.62109375,high_precision
Conservative,FloodFrequency,{'max_flood_count': 2},1.0,0.3,0.3,2,1,0.2,241,121,120,12,29,24,57,23,97,64,0.7125,0.47107438016528924,0.5671641791044777,0.6390041493775933,high_precision
Conservative,FloodFrequency,{'max_flood_count': 2},1.0,0.4,0.2,2,1,0.2,256,130,126,12,29,24,23,5,121,107,0.8214285714285714,0.17692307692307693,0.2911392405063291,0.5625,high_precision
Conservative,FloodFrequency,{'max_flood_count': 2},1.0,0.5,0.2,2,1,0.2,256,130,126,12,29,24,8,3,123,122,0.7272727272727273,0.06153846153846154,0.11347517730496455,0.51171875,high_precision
Conservative,FloodFrequency,{'max_flood_count': 2},2.0,0.2,0.2,2,1,0.2,331,130,201,12,29,24,71,19,182,59,0.7888888888888889,0.5461538461538461,0.6454545454545454,0.7643504531722054,high_precision
Conservative,FloodFrequency,{'max_flood_count': 2},2.0,0.3,0.2,2,1,0.2,331,130,201,12,29,24,43,10,191,87,0.8113207547169812,0.33076923076923076,0.4699453551912569,0.7069486404833837,high_precision
Conservative,FloodFrequency,{'max_flood_count': 2},2.0,0.4,0.2,2,1,0.2,331,130,201,12,29,24,23,5,196,107,0.8214285714285714,0.17692307692307693,0.2911392405063291,0.6616314199395771,high_precision
Conservative,FloodFrequency,{'max_flood_count': 2},2.0,0.5,0.2,2,1,0.2,331,130,201,12,29,24,8,3,198,122,0.7272727272727273,0.06153846153846154,0.11347517730496455,0.622356495468278,high_precision
Conservative,FloodFrequency,{'max_flood_count': 3},1.0,0.1,0.2,2,1,0.2,260,130,130,14,29,24,120,41,89,10,0.7453416149068323,0.9230769230769231,0.8247422680412372,0.8038461538461539,high_precision
Conservative,FloodFrequency,{'max_flood_count': 3},1.0,0.2,0.2,2,1,0.2,260,130,130,14,29,24,71,16,114,59,0.8160919540229885,0.5461538461538461,0.6543778801843317,0.7115384615384616,high_precision
Conservative,FloodFrequency,{'max_flood_count': 3},1.0,0.2,0.3,2,1,0.2,242,121,121,14,29,24,77,30,91,44,0.719626168224299,0.6363636363636364,0.6754385964912281,0.6942148760330579,high_precision
Conservative,FloodFrequency,{'max_flood_count': 3},1.0,0.3,0.2,2,1,0.2,260,130,130,14,29,24,43,10,120,87,0.8113207547169812,0.33076923076923076,0.4699453551912569,0.6269230769230769,high_precision
Conservative,FloodFrequency,{'max_flood_count': 3},1.0,0.3,0.3,2,1,0.2,242,121,121,14,29,24,57,24,97,64,0.7037037037037037,0.47107438016528924,0.5643564356435643,0.6363636363636364,high_precision
Conservative,FloodFrequency,{'max_flood_count': 3},1.0,0.4,0.2,2,1,0.2,260,130,130,14,29,24,23,5,125,107,0.8214285714285714,0.17692307692307693,0.2911392405063291,0.5692307692307692,high_precision
Conservative,FloodFrequency,{'max_flood_count': 3},1.0,0.5,0.2,2,1,0.2,260,130,130,14,29,24,8,3,127,122,0.7272727272727273,0.06153846153846154,0.11347517730496455,0.5192307692307693,high_precision
Conservative,FloodFrequency,{'max_flood_count': 3},2.0,0.2,0.2,2,1,0.2,345,130,215,14,29,24,71,21,194,59,0.7717391304347826,0.5461538461538461,0.6396396396396397,0.7681159420289855,high_precision
Conservative,FloodFrequency,{'max_flood_count': 3},2.0,0.3,0.2,2,1,0.2,345,130,215,14,29,24,43,11,204,87,0.7962962962962963,0.33076923076923076,0.4673913043478261,0.7159420289855073,high_precision
Conservative,FloodFrequency,{'max_flood_count': 3},2.0,0.4,0.2,2,1,0.2,345,130,215,14,29,24,23,6,209,107,0.7931034482758621,0.17692307692307693,0.2893081761006289,0.672463768115942,high_precision
Conservative,FloodFrequency,{'max_flood_count': 3},2.0,0.5,0.2,2,1,0.2,345,130,215,14,29,24,8,3,212,122,0.7272727272727273,0.06153846153846154,0.11347517730496455,0.6376811594202898,high_precision
Conservative,RecentActivity,{'max_recent_floods': 0},1.0,0.1,0.2,2,1,0.2,260,130,130,17,29,24,120,45,85,10,0.7272727272727273,0.9230769230769231,0.8135593220338984,0.7884615384615384,high_precision
Conservative,RecentActivity,{'max_recent_floods': 0},1.0,0.2,0.2,2,1,0.2,260,130,130,17,29,24,71,20,110,59,0.7802197802197802,0.5461538461538461,0.6425339366515836,0.6961538461538461,high_precision
Conservative,RecentActivity,{'max_recent_floods': 0},1.0,0.3,0.2,2,1,0.2,260,130,130,17,29,24,43,10,120,87,0.8113207547169812,0.33076923076923076,0.4699453551912569,0.6269230769230769,high_precision
Conservative,RecentActivity,{'max_recent_floods': 0},1.0,0.4,0.2,2,1,0.2,260,130,130,17,29,24,23,6,124,107,0.7931034482758621,0.17692307692307693,0.2893081761006289,0.5653846153846154,high_precision
Conservative,RecentActivity,{'max_recent_floods': 0},1.0,0.5,0.2,2,1,0.2,260,130,130,17,29,24,8,2,128,122,0.8,0.06153846153846154,0.1142857142857143,0.5230769230769231,high_precision
Conservative,RecentActivity,{'max_recent_floods': 0},2.0,0.3,0.2,2,1,0.2,357,130,227,17,29,24,43,12,215,87,0.7818181818181819,0.33076923076923076,0.4648648648648648,0.7226890756302521,high_precision
Conservative,RecentActivity,{'max_recent_floods': 0},2.0,0.4,0.2,2,1,0.2,357,130,227,17,29,24,23,7,220,107,0.7666666666666667,0.17692307692307693,0.2875,0.680672268907563,high_precision
Conservative,RecentActivity,{'max_recent_floods': 0},2.0,0.5,0.2,2,1,0.2,357,130,227,17,29,24,8,2,225,122,0.8,0.06153846153846154,0.1142857142857143,0.6526610644257703,high_precision
Conservative,RecentActivity,{'max_recent_floods': 1},1.0,0.1,0.2,2,1,0.2,260,130,130,27,29,24,120,47,83,10,0.718562874251497,0.9230769230769231,0.8080808080808081,0.7807692307692308,high_precision
Conservative,RecentActivity,{'max_recent_floods': 1},1.0,0.2,0.2,2,1,0.2,260,130,130,27,29,24,71,21,109,59,0.7717391304347826,0.5461538461538461,0.6396396396396397,0.6923076923076923,high_precision
Conservative,RecentActivity,{'max_recent_floods': 1},1.0,0.3,0.2,2,1,0.2,260,130,130,27,29,24,43,12,118,87,0.7818181818181819,0.33076923076923076,0.4648648648648648,0.6192307692307693,high_precision
Conservative,RecentActivity,{'max_recent_floods': 1},1.0,0.4,0.2,2,1,0.2,260,130,130,27,29,24,23,7,123,107,0.7666666666666667,0.17692307692307693,0.2875,0.5615384615384615,high_precision
Conservative,RecentActivity,{'max_recent_floods': 1},1.0,0.5,0.2,2,1,0.2,260,130,130,27,29,24,8,3,127,122,0.7272727272727273,0.06153846153846154,0.11347517730496455,0.5192307692307693,high_precision
Conservative,RecentActivity,{'max_recent_floods': 1},2.0,0.3,0.2,2,1,0.2,385,130,255,27,29,24,43,17,238,87,0.7166666666666667,0.33076923076923076,0.4526315789473684,0.7298701298701299,high_precision
Conservative,RecentActivity,{'max_recent_floods': 2},1.0,0.1,0.2,2,1,0.2,260,130,130,34,29,24,120,43,87,10,0.7361963190184049,0.9230769230769231,0.8191126279863482,0.7961538461538461,high_precision
Conservative,RecentActivity,{'max_recent_floods': 2},1.0,0.2,0.2,2,1,0.2,260,130,130,34,29,24,71,18,112,59,0.797752808988764,0.5461538461538461,0.6484018264840182,0.7038461538461539,high_precision
Conservative,RecentActivity,{'max_recent_floods': 2},1.0,0.2,0.3,2,1,0.2,242,121,121,34,29,24,77,30,91,44,0.719626168224299,0.6363636363636364,0.6754385964912281,0.6942148760330579,high_precision
Conservative,RecentActivity,{'max_recent_floods': 2},1.0,0.3,0.2,2,1,0.2,260,130,130,34,29,24,43,10,120,87,0.8113207547169812,0.33076923076923076,0.4699453551912569,0.6269230769230769,high_precision
Conservative,RecentActivity,{'max_recent_floods': 2},1.0,0.3,0.3,2,1,0.2,242,121,121,34,29,24,57,24,97,64,0.7037037037037037,0.47107438016528924,0.5643564356435643,0.6363636363636364,high_precision
Conservative,RecentActivity,{'max_recent_floods': 2},1.0,0.4,0.2,2,1,0.2,260,130,130,34,29,24,23,5,125,107,0.8214285714285714,0.17692307692307693,0.2911392405063291,0.5692307692307692,high_precision
Conservative,RecentActivity,{'max_recent_floods': 2},1.0,0.5,0.2,2,1,0.2,260,130,130,34,29,24,8,3,127,122,0.7272727272727273,0.06153846153846154,0.11347517730496455,0.5192307692307693,high_precision
Conservative,RecentActivity,{'max_recent_floods': 2},2.0,0.3,0.2,2,1,0.2,390,130,260,34,29,24,43,17,243,87,0.7166666666666667,0.33076923076923076,0.4526315789473684,0.7333333333333333,high_precision
Conservative,CombinedConservative,"{'prob_threshold': 0.1, 'max_flood_count': 2, 'max_recent_floods': 1}",1.0,0.1,0.2,2,1,0.2,249,130,119,10,29,24,120,38,81,10,0.759493670886076,0.9230769230769231,0.8333333333333334,0.8072289156626506,high_precision
Conservative,CombinedConservative,"{'prob_threshold': 0.1, 'max_flood_count': 2, 'max_recent_floods': 1}",1.0,0.2,0.2,2,1,0.2,249,130,119,10,29,24,71,15,104,59,0.8255813953488372,0.5461538461538461,0.6574074074074073,0.7028112449799196,high_precision
Conservative,CombinedConservative,"{'prob_threshold': 0.1, 'max_flood_count': 2, 'max_recent_floods': 1}",1.0,0.2,0.3,2,1,0.2,235,121,114,10,29,24,77,29,85,44,0.7264150943396226,0.6363636363636364,0.6784140969162996,0.6893617021276596,high_precision
Conservative,CombinedConservative,"{'prob_threshold': 0.1, 'max_flood_count': 2, 'max_recent_floods': 1}",1.0,0.3,0.2,2,1,0.2,249,130,119,10,29,24,43,10,109,87,0.8113207547169812,0.33076923076923076,0.4699453551912569,0.6104417670682731,high_precision
Conservative,CombinedConservative,"{'prob_threshold': 0.1, 'max_flood_count': 2, 'max_recent_floods': 1}",1.0,0.3,0.3,2,1,0.2,235,121,114,10,29,24,57,23,91,64,0.7125,0.47107438016528924,0.5671641791044777,0.6297872340425532,high_precision
Conservative,CombinedConservative,"{'prob_threshold': 0.1, 'max_flood_count': 2, 'max_recent_floods': 1}",1.0,0.4,0.2,2,1,0.2,249,130,119,10,29,24,23,5,114,107,0.8214285714285714,0.17692307692307693,0.2911392405063291,0.5502008032128514,high_precision
Conservative,CombinedConservative,"{'prob_threshold': 0.1, 'max_flood_count': 2, 'max_recent_floods': 1}",1.0,0.5,0.2,2,1,0.2,249,130,119,10,29,24,8,3,116,122,0.7272727272727273,0.06153846153846154,0.11347517730496455,0.4979919678714859,high_precision
Conservative,CombinedConservative,"{'prob_threshold': 0.1, 'max_flood_count': 2, 'max_recent_floods': 1}",2.0,0.1,0.2,2,1,0.2,314,130,184,10,29,24,120,51,133,10,0.7017543859649122,0.9230769230769231,0.7973421926910299,0.8057324840764332,high_precision
Conservative,CombinedConservative,"{'prob_threshold': 0.1, 'max_flood_count': 2, 'max_recent_floods': 1}",2.0,0.2,0.2,2,1,0.2,314,130,184,10,29,24,71,18,166,59,0.797752808988764,0.5461538461538461,0.6484018264840182,0.7547770700636943,high_precision
Conservative,CombinedConservative,"{'prob_threshold': 0.1, 'max_flood_count': 2, 'max_recent_floods': 1}",2.0,0.3,0.2,2,1,0.2,314,130,184,10,29,24,43,10,174,87,0.8113207547169812,0.33076923076923076,0.4699453551912569,0.6910828025477707,high_precision
Conservative,CombinedConservative,"{'prob_threshold': 0.1, 'max_flood_count': 2, 'max_recent_floods': 1}",2.0,0.4,0.2,2,1,0.2,314,130,184,10,29,24,23,5,179,107,0.8214285714285714,0.17692307692307693,0.2911392405063291,0.643312101910828,high_precision
Conservative,CombinedConservative,"{'prob_threshold': 0.1, 'max_flood_count': 2, 'max_recent_floods': 1}",2.0,0.5,0.2,2,1,0.2,314,130,184,10,29,24,8,3,181,122,0.7272727272727273,0.06153846153846154,0.11347517730496455,0.6019108280254777,high_precision
Conservative,CombinedConservative,"{'prob_threshold': 0.15, 'max_flood_count': 3, 'max_recent_floods': 2}",1.0,0.1,0.2,2,1,0.2,260,130,130,14,29,24,120,41,89,10,0.7453416149068323,0.9230769230769231,0.8247422680412372,0.8038461538461539,high_precision
Conservative,CombinedConservative,"{'prob_threshold': 0.15, 'max_flood_count': 3, 'max_recent_floods': 2}",1.0,0.2,0.2,2,1,0.2,260,130,130,14,29,24,71,16,114,59,0.8160919540229885,0.5461538461538461,0.6543778801843317,0.7115384615384616,high_precision
Conservative,CombinedConservative,"{'prob_threshold': 0.15, 'max_flood_count': 3, 'max_recent_floods': 2}",1.0,0.2,0.3,2,1,0.2,242,121,121,14,29,24,77,30,91,44,0.719626168224299,0.6363636363636364,0.6754385964912281,0.6942148760330579,high_precision
Conservative,CombinedConservative,"{'prob_threshold': 0.15, 'max_flood_count': 3, 'max_recent_floods': 2}",1.0,0.3,0.2,2,1,0.2,260,130,130,14,29,24,43,10,120,87,0.8113207547169812,0.33076923076923076,0.4699453551912569,0.6269230769230769,high_precision
Conservative,CombinedConservative,"{'prob_threshold': 0.15, 'max_flood_count': 3, 'max_recent_floods': 2}",1.0,0.3,0.3,2,1,0.2,242,121,121,14,29,24,57,24,97,64,0.7037037037037037,0.47107438016528924,0.5643564356435643,0.6363636363636364,high_precision
Conservative,CombinedConservative,"{'prob_threshold': 0.15, 'max_flood_count': 3, 'max_recent_floods': 2}",1.0,0.4,0.2,2,1,0.2,260,130,130,14,29,24,23,5,125,107,0.8214285714285714,0.17692307692307693,0.2911392405063291,0.5692307692307692,high_precision
Conservative,CombinedConservative,"{'prob_threshold': 0.15, 'max_flood_count': 3, 'max_recent_floods': 2}",1.0,0.5,0.2,2,1,0.2,260,130,130,14,29,24,8,3,127,122,0.7272727272727273,0.06153846153846154,0.11347517730496455,0.5192307692307693,high_precision
Conservative,CombinedConservative,"{'prob_threshold': 0.15, 'max_flood_count': 3, 'max_recent_floods': 2}",2.0,0.2,0.2,2,1,0.2,345,130,215,14,29,24,71,21,194,59,0.7717391304347826,0.5461538461538461,0.6396396396396397,0.7681159420289855,high_precision
Conservative,CombinedConservative,"{'prob_threshold': 0.15, 'max_flood_count': 3, 'max_recent_floods': 2}",2.0,0.3,0.2,2,1,0.2,345,130,215,14,29,24,43,11,204,87,0.7962962962962963,0.33076923076923076,0.4673913043478261,0.7159420289855073,high_precision
Conservative,CombinedConservative,"{'prob_threshold': 0.15, 'max_flood_count': 3, 'max_recent_floods': 2}",2.0,0.4,0.2,2,1,0.2,345,130,215,14,29,24,23,6,209,107,0.7931034482758621,0.17692307692307693,0.2893081761006289,0.672463768115942,high_precision
Conservative,CombinedConservative,"{'prob_threshold': 0.15, 'max_flood_count': 3, 'max_recent_floods': 2}",2.0,0.5,0.2,2,1,0.2,345,130,215,14,29,24,8,3,212,122,0.7272727272727273,0.06153846153846154,0.11347517730496455,0.6376811594202898,high_precision
Baseline,MarginalProbability,{'prob_threshold': 0.05},1.0,0.1,0.2,3,2,0.3,243,123,120,12,29,24,100,15,105,23,0.8695652173913043,0.8130081300813008,0.8403361344537815,0.8436213991769548,high_precision
Baseline,MarginalProbability,{'prob_threshold': 0.05},1.0,0.1,0.3,3,2,0.3,226,113,113,12,29,24,95,18,95,18,0.8407079646017699,0.8407079646017699,0.8407079646017699,0.8407079646017699,high_precision
Baseline,MarginalProbability,{'prob_threshold': 0.05},1.0,0.1,0.5,3,2,0.3,168,84,84,12,29,24,76,25,59,8,0.7524752475247525,0.9047619047619048,0.8216216216216216,0.8035714285714286,high_precision
Baseline,MarginalProbability,{'prob_threshold': 0.05},1.0,0.1,0.7,3,2,0.3,124,62,62,12,29,24,55,22,40,7,0.7142857142857143,0.8870967741935484,0.7913669064748201,0.7661290322580645,high_precision
Baseline,MarginalProbability,{'prob_threshold': 0.05},1.0,0.2,0.2,3,2,0.3,243,123,120,12,29,24,46,3,117,77,0.9387755102040817,0.37398373983739835,0.5348837209302325,0.6707818930041153,high_precision
Baseline,MarginalProbability,{'prob_threshold': 0.05},1.0,0.2,0.3,3,2,0.3,226,113,113,12,29,24,48,6,107,65,0.8888888888888888,0.4247787610619469,0.5748502994011976,0.6858407079646017,high_precision
Baseline,MarginalProbability,{'prob_threshold': 0.05},1.0,0.2,0.5,3,2,0.3,168,84,84,12,29,24,43,6,78,41,0.8775510204081632,0.5119047619047619,0.6466165413533834,0.7202380952380952,high_precision
Baseline,MarginalProbability,{'prob_threshold': 0.05},1.0,0.2,0.7,3,2,0.3,124,62,62,12,29,24,31,6,56,31,0.8378378378378378,0.5,0.6262626262626263,0.7016129032258065,high_precision
Baseline,MarginalProbability,{'prob_threshold': 0.05},1.0,0.3,0.2,3,2,0.3,243,123,120,12,29,24,36,0,120,87,1.0,0.2926829268292683,0.45283018867924524,0.6419753086419753,high_precision
Baseline,MarginalProbability,{'prob_threshold': 0.05},1.0,0.3,0.3,3,2,0.3,226,113,113,12,29,24,35,2,111,78,0.9459459459459459,0.30973451327433627,0.4666666666666667,0.6460176991150443,high_precision
Baseline,MarginalProbability,{'prob_threshold': 0.05},1.0,0.3,0.5,3,2,0.3,168,84,84,12,29,24,33,3,81,51,0.9166666666666666,0.39285714285714285,0.55,0.6785714285714286,high_precision
Baseline,MarginalProbability,{'prob_threshold': 0.05},1.0,0.3,0.7,3,2,0.3,124,62,62,12,29,24,24,6,56,38,0.8,0.3870967741935484,0.5217391304347827,0.6451612903225806,high_precision
Baseline,MarginalProbability,{'prob_threshold': 0.05},1.0,0.4,0.2,3,2,0.3,243,123,120,12,29,24,13,0,120,110,1.0,0.10569105691056911,0.1911764705882353,0.5473251028806584,high_precision
Baseline,MarginalProbability,{'prob_threshold': 0.05},1.0,0.4,0.3,3,2,0.3,226,113,113,12,29,24,15,2,111,98,0.8823529411764706,0.13274336283185842,0.2307692307692308,0.5575221238938053,high_precision
Baseline,MarginalProbability,{'prob_threshold': 0.05},1.0,0.4,0.5,3,2,0.3,168,84,84,12,29,24,17,2,82,67,0.8947368421052632,0.20238095238095238,0.33009708737864074,0.5892857142857143,high_precision
Baseline,MarginalProbability,{'prob_threshold': 0.05},1.0,0.4,0.7,3,2,0.3,124,62,62,12,29,24,15,4,58,47,0.7894736842105263,0.24193548387096775,0.37037037037037035,0.5887096774193549,high_precision
Baseline,MarginalProbability,{'prob_threshold': 0.05},1.0,0.5,0.3,3,2,0.3,226,113,113,12,29,24,4,1,112,109,0.8,0.035398230088495575,0.06779661016949151,0.5132743362831859,high_precision
Baseline,MarginalProbability,{'prob_threshold': 0.05},1.0,0.5,0.5,3,2,0.3,168,84,84,12,29,24,6,1,83,78,0.8571428571428571,0.07142857142857142,0.13186813186813187,0.5297619047619048,high_precision
Baseline,MarginalProbability,{'prob_threshold': 0.05},1.0,0.5,0.7,3,2,0.3,124,62,62,12,29,24,9,3,59,53,0.75,0.14516129032258066,0.24324324324324328,0.5483870967741935,high_precision
Baseline,MarginalProbability,{'prob_threshold': 0.05},2.0,0.1,0.2,3,2,0.3,319,123,196,12,29,24,100,23,173,23,0.8130081300813008,0.8130081300813008,0.8130081300813008,0.8557993730407524,high_precision
Baseline,MarginalProbability,{'prob_threshold': 0.05},2.0,0.1,0.3,3,2,0.3,304,113,191,12,29,24,95,31,160,18,0.753968253968254,0.8407079646017699,0.7949790794979079,0.8388157894736842,high_precision
Baseline,MarginalProbability,{'prob_threshold': 0.05},2.0,0.2,0.2,3,2,0.3,319,123,196,12,29,24,46,6,190,77,0.8846153846153846,0.37398373983739835,0.5257142857142857,0.7398119122257053,high_precision
Baseline,MarginalProbability,{'prob_threshold': 0.05},2.0,0.2,0.3,3,2,0.3,304,113,191,12,29,24,48,12,179,65,0.8,0.4247787610619469,0.5549132947976878,0.7467105263157895,high_precision
Baseline,MarginalProbability,{'prob_threshold': 0.05},2.0,0.3,0.2,3,2,0.3,319,123,196,12,29,24,36,3,193,87,0.9230769230769231,0.2926829268292683,0.4444444444444444,0.7178683385579937,high_precision
Baseline,MarginalProbability,{'prob_threshold': 0.05},2.0,0.3,0.3,3,2,0.3,304,113,191,12,29,24,35,7,184,78,0.8333333333333334,0.30973451327433627,0.45161290322580644,0.7203947368421053,high_precision
Baseline,MarginalProbability,{'prob_threshold': 0.05},2.0,0.3,0.5,3,2,0.3,243,84,159,12,29,24,33,11,148,51,0.75,0.39285714285714285,0.515625,0.7448559670781894,high_precision
Baseline,MarginalProbability,{'prob_threshold': 0.05},2.0,0.4,0.2,3,2,0.3,319,123,196,12,29,24,13,1,195,110,0.9285714285714286,0.10569105691056911,0.18978102189781024,0.6520376175548589,high_precision
Baseline,MarginalProbability,{'prob_threshold': 0.05},2.0,0.4,0.3,3,2,0.3,304,113,191,12,29,24,15,4,187,98,0.7894736842105263,0.13274336283185842,0.2272727272727273,0.6644736842105263,high_precision
Baseline,MarginalProbability,{'prob_threshold': 0.05},2.0,0.4,0.5,3,2,0.3,243,84,159,12,29,24,17,7,152,67,0.7083333333333334,0.20238095238095238,0.3148148148148148,0.6954732510288066,high_precision
Baseline,MarginalProbability,{'prob_threshold': 0.1},1.0,0.1,0.2,3,2,0.3,246,123,123,25,29,24,100,15,108,23,0.8695652173913043,0.8130081300813008,0.8403361344537815,0.8455284552845529,high_precision
Baseline,MarginalProbability,{'prob_threshold': 0.1},1.0,0.1,0.3,3,2,0.3,226,113,113,25,29,24,95,18,95,18,0.8407079646017699,0.8407079646017699,0.8407079646017699,0.8407079646017699,high_precision
Baseline,MarginalProbability,{'prob_threshold': 0.1},1.0,0.1,0.5,3,2,0.3,168,84,84,25,29,24,76,25,59,8,0.7524752475247525,0.9047619047619048,0.8216216216216216,0.8035714285714286,high_precision
Baseline,MarginalProbability,{'prob_threshold': 0.1},1.0,0.1,0.7,3,2,0.3,124,62,62,25,29,24,55,22,40,7,0.7142857142857143,0.8870967741935484,0.7913669064748201,0.7661290322580645,high_precision
Baseline,MarginalProbability,{'prob_threshold': 0.1},1.0,0.2,0.2,3,2,0.3,246,123,123,25,29,24,46,3,120,77,0.9387755102040817,0.37398373983739835,0.5348837209302325,0.6747967479674797,high_precision
Baseline,MarginalProbability,{'prob_threshold': 0.1},1.0,0.2,0.3,3,2,0.3,226,113,113,25,29,24,48,6,107,65,0.8888888888888888,0.4247787610619469,0.5748502994011976,0.6858407079646017,high_precision
Baseline,MarginalProbability,{'prob_threshold': 0.1},1.0,0.2,0.5,3,2,0.3,168,84,84,25,29,24,43,6,78,41,0.8775510204081632,0.5119047619047619,0.6466165413533834,0.7202380952380952,high_precision
Baseline,MarginalProbability,{'prob_threshold': 0.1},1.0,0.2,0.7,3,2,0.3,124,62,62,25,29,24,31,6,56,31,0.8378378378378378,0.5,0.6262626262626263,0.7016129032258065,high_precision
Baseline,MarginalProbability,{'prob_threshold': 0.1},1.0,0.3,0.2,3,2,0.3,246,123,123,25,29,24,36,0,123,87,1.0,0.2926829268292683,0.45283018867924524,0.6463414634146342,high_precision
Baseline,MarginalProbability,{'prob_threshold': 0.1},1.0,0.3,0.3,3,2,0.3,226,113,113,25,29,24,35,2,111,78,0.9459459459459459,0.30973451327433627,0.4666666666666667,0.6460176991150443,high_precision
Baseline,MarginalProbability,{'prob_threshold': 0.1},1.0,0.3,0.5,3,2,0.3,168,84,84,25,29,24,33,3,81,51,0.9166666666666666,0.39285714285714285,0.55,0.6785714285714286,high_precision
Baseline,MarginalProbability,{'prob_threshold': 0.1},1.0,0.3,0.7,3,2,0.3,124,62,62,25,29,24,24,6,56,38,0.8,0.3870967741935484,0.5217391304347827,0.6451612903225806,high_precision
Baseline,MarginalProbability,{'prob_threshold': 0.1},1.0,0.4,0.2,3,2,0.3,246,123,123,25,29,24,13,0,123,110,1.0,0.10569105691056911,0.1911764705882353,0.5528455284552846,high_precision
Baseline,MarginalProbability,{'prob_threshold': 0.1},1.0,0.4,0.3,3,2,0.3,226,113,113,25,29,24,15,2,111,98,0.8823529411764706,0.13274336283185842,0.2307692307692308,0.5575221238938053,high_precision
Baseline,MarginalProbability,{'prob_threshold': 0.1},1.0,0.4,0.5,3,2,0.3,168,84,84,25,29,24,17,2,82,67,0.8947368421052632,0.20238095238095238,0.33009708737864074,0.5892857142857143,high_precision
Baseline,MarginalProbability,{'prob_threshold': 0.1},1.0,0.4,0.7,3,2,0.3,124,62,62,25,29,24,15,4,58,47,0.7894736842105263,0.24193548387096775,0.37037037037037035,0.5887096774193549,high_precision
Baseline,MarginalProbability,{'prob_threshold': 0.1},1.0,0.5,0.3,3,2,0.3,226,113,113,25,29,24,4,1,112,109,0.8,0.035398230088495575,0.06779661016949151,0.5132743362831859,high_precision
Baseline,MarginalProbability,{'prob_threshold': 0.1},1.0,0.5,0.5,3,2,0.3,168,84,84,25,29,24,6,1,83,78,0.8571428571428571,0.07142857142857142,0.13186813186813187,0.5297619047619048,high_precision
Baseline,MarginalProbability,{'prob_threshold': 0.1},1.0,0.5,0.7,3,2,0.3,124,62,62,25,29,24,9,3,59,53,0.75,0.14516129032258066,0.24324324324324328,0.5483870967741935,high_precision
Baseline,MarginalProbability,{'prob_threshold': 0.1},2.0,0.1,0.2,3,2,0.3,360,123,237,25,29,24,100,42,195,23,0.704225352112676,0.8130081300813008,0.7547169811320754,0.8194444444444444,high_precision
Baseline,MarginalProbability,{'prob_threshold': 0.1},2.0,0.2,0.2,3,2,0.3,360,123,237,25,29,24,46,7,230,77,0.8679245283018868,0.37398373983739835,0.5227272727272727,0.7666666666666667,high_precision
Baseline,MarginalProbability,{'prob_threshold': 0.1},2.0,0.2,0.3,3,2,0.3,336,113,223,25,29,24,48,15,208,65,0.7619047619047619,0.4247787610619469,0.5454545454545454,0.7619047619047619,high_precision
Baseline,MarginalProbability,{'prob_threshold': 0.1},2.0,0.3,0.2,3,2,0.3,360,123,237,25,29,24,36,3,234,87,0.9230769230769231,0.2926829268292683,0.4444444444444444,0.75,high_precision
Baseline,MarginalProbability,{'prob_threshold': 0.1},2.0,0.3,0.3,3,2,0.3,336,113,223,25,29,24,35,10,213,78,0.7777777777777778,0.30973451327433627,0.44303797468354433,0.7380952380952381,high_precision
Baseline,MarginalProbability,{'prob_threshold': 0.1},2.0,0.3,0.5,3,2,0.3,252,84,168,25,29,24,33,13,155,51,0.717391304347826,0.39285714285714285,0.5076923076923077,0.746031746031746,high_precision
Baseline,MarginalProbability,{'prob_threshold': 0.1},2.0,0.4,0.2,3,2,0.3,360,123,237,25,29,24,13,1,236,110,0.9285714285714286,0.10569105691056911,0.18978102189781024,0.6916666666666667,high_precision
Baseline,MarginalProbability,{'prob_threshold': 0.1},2.0,0.4,0.3,3,2,0.3,336,113,223,25,29,24,15,6,217,98,0.7142857142857143,0.13274336283185842,0.2238805970149254,0.6904761904761905,high_precision
Baseline,MarginalProbability,{'prob_threshold': 0.15},1.0,0.1,0.2,3,2,0.3,246,123,123,32,29,24,100,15,108,23,0.8695652173913043,0.8130081300813008,0.8403361344537815,0.8455284552845529,high_precision
Baseline,MarginalProbability,{'prob_threshold': 0.15},1.0,0.1,0.3,3,2,0.3,226,113,113,32,29,24,95,18,95,18,0.8407079646017699,0.8407079646017699,0.8407079646017699,0.8407079646017699,high_precision
Baseline,MarginalProbability,{'prob_threshold': 0.15},1.0,0.1,0.5,3,2,0.3,168,84,84,32,29,24,76,25,59,8,0.7524752475247525,0.9047619047619048,0.8216216216216216,0.8035714285714286,high_precision
Baseline,MarginalProbability,{'prob_threshold': 0.15},1.0,0.1,0.7,3,2,0.3,124,62,62,32,29,24,55,22,40,7,0.7142857142857143,0.8870967741935484,0.7913669064748201,0.7661290322580645,high_precision
Baseline,MarginalProbability,{'prob_threshold': 0.15},1.0,0.2,0.2,3,2,0.3,246,123,123,32,29,24,46,3,120,77,0.9387755102040817,0.37398373983739835,0.5348837209302325,0.6747967479674797,high_precision
Baseline,MarginalProbability,{'prob_threshold': 0.15},1.0,0.2,0.3,3,2,0.3,226,113,113,32,29,24,48,6,107,65,0.8888888888888888,0.4247787610619469,0.5748502994011976,0.6858407079646017,high_precision
Baseline,MarginalProbability,{'prob_threshold': 0.15},1.0,0.2,0.5,3,2,0.3,168,84,84,32,29,24,43,6,78,41,0.8775510204081632,0.5119047619047619,0.6466165413533834,0.7202380952380952,high_precision
Baseline,MarginalProbability,{'prob_threshold': 0.15},1.0,0.2,0.7,3,2,0.3,124,62,62,32,29,24,31,6,56,31,0.8378378378378378,0.5,0.6262626262626263,0.7016129032258065,high_precision
Baseline,MarginalProbability,{'prob_threshold': 0.15},1.0,0.3,0.2,3,2,0.3,246,123,123,32,29,24,36,0,123,87,1.0,0.2926829268292683,0.45283018867924524,0.6463414634146342,high_precision
Baseline,MarginalProbability,{'prob_threshold': 0.15},1.0,0.3,0.3,3,2,0.3,226,113,113,32,29,24,35,2,111,78,0.9459459459459459,0.30973451327433627,0.4666666666666667,0.6460176991150443,high_precision
Baseline,MarginalProbability,{'prob_threshold': 0.15},1.0,0.3,0.5,3,2,0.3,168,84,84,32,29,24,33,3,81,51,0.9166666666666666,0.39285714285714285,0.55,0.6785714285714286,high_precision
Baseline,MarginalProbability,{'prob_threshold': 0.15},1.0,0.3,0.7,3,2,0.3,124,62,62,32,29,24,24,6,56,38,0.8,0.3870967741935484,0.5217391304347827,0.6451612903225806,high_precision
Baseline,MarginalProbability,{'prob_threshold': 0.15},1.0,0.4,0.2,3,2,0.3,246,123,123,32,29,24,13,0,123,110,1.0,0.10569105691056911,0.1911764705882353,0.5528455284552846,high_precision
Baseline,MarginalProbability,{'prob_threshold': 0.15},1.0,0.4,0.3,3,2,0.3,226,113,113,32,29,24,15,2,111,98,0.8823529411764706,0.13274336283185842,0.2307692307692308,0.5575221238938053,high_precision
Baseline,MarginalProbability,{'prob_threshold': 0.15},1.0,0.4,0.5,3,2,0.3,168,84,84,32,29,24,17,2,82,67,0.8947368421052632,0.20238095238095238,0.33009708737864074,0.5892857142857143,high_precision
Baseline,MarginalProbability,{'prob_threshold': 0.15},1.0,0.4,0.7,3,2,0.3,124,62,62,32,29,24,15,4,58,47,0.7894736842105263,0.24193548387096775,0.37037037037037035,0.5887096774193549,high_precision
Baseline,MarginalProbability,{'prob_threshold': 0.15},1.0,0.5,0.3,3,2,0.3,226,113,113,32,29,24,4,1,112,109,0.8,0.035398230088495575,0.06779661016949151,0.5132743362831859,high_precision
Baseline,MarginalProbability,{'prob_threshold': 0.15},1.0,0.5,0.5,3,2,0.3,168,84,84,32,29,24,6,1,83,78,0.8571428571428571,0.07142857142857142,0.13186813186813187,0.5297619047619048,high_precision
Baseline,MarginalProbability,{'prob_threshold': 0.15},1.0,0.5,0.7,3,2,0.3,124,62,62,32,29,24,9,3,59,53,0.75,0.14516129032258066,0.24324324324324328,0.5483870967741935,high_precision
Baseline,MarginalProbability,{'prob_threshold': 0.15},2.0,0.2,0.2,3,2,0.3,368,123,245,32,29,24,46,7,238,77,0.8679245283018868,0.37398373983739835,0.5227272727272727,0.7717391304347826,high_precision
Baseline,MarginalProbability,{'prob_threshold': 0.15},2.0,0.2,0.3,3,2,0.3,339,113,226,32,29,24,48,15,211,65,0.7619047619047619,0.4247787610619469,0.5454545454545454,0.7640117994100295,high_precision
Baseline,MarginalProbability,{'prob_threshold': 0.15},2.0,0.3,0.2,3,2,0.3,368,123,245,32,29,24,36,3,242,87,0.9230769230769231,0.2926829268292683,0.4444444444444444,0.7554347826086957,high_precision
Baseline,MarginalProbability,{'prob_threshold': 0.15},2.0,0.3,0.3,3,2,0.3,339,113,226,32,29,24,35,10,216,78,0.7777777777777778,0.30973451327433627,0.44303797468354433,0.7404129793510325,high_precision
Baseline,MarginalProbability,{'prob_threshold': 0.15},2.0,0.3,0.5,3,2,0.3,252,84,168,32,29,24,33,13,155,51,0.717391304347826,0.39285714285714285,0.5076923076923077,0.746031746031746,high_precision
Baseline,MarginalProbability,{'prob_threshold': 0.15},2.0,0.4,0.2,3,2,0.3,368,123,245,32,29,24,13,1,244,110,0.9285714285714286,0.10569105691056911,0.18978102189781024,0.6983695652173914,high_precision
Baseline,MarginalProbability,{'prob_threshold': 0.15},2.0,0.4,0.3,3,2,0.3,339,113,226,32,29,24,15,6,220,98,0.7142857142857143,0.13274336283185842,0.2238805970149254,0.6932153392330384,high_precision
Baseline,FloodFrequency,{'max_flood_count': 3},1.0,0.1,0.2,3,2,0.3,173,123,50,2,29,24,100,7,43,23,0.9345794392523364,0.8130081300813008,0.8695652173913043,0.8265895953757225,high_precision
Baseline,FloodFrequency,{'max_flood_count': 3},1.0,0.1,0.3,3,2,0.3,163,113,50,2,29,24,95,8,42,18,0.9223300970873787,0.8407079646017699,0.8796296296296297,0.8404907975460123,high_precision
Baseline,FloodFrequency,{'max_flood_count': 3},1.0,0.1,0.5,3,2,0.3,134,84,50,2,29,24,76,11,39,8,0.8735632183908046,0.9047619047619048,0.8888888888888888,0.8582089552238806,high_precision
Baseline,FloodFrequency,{'max_flood_count': 3},1.0,0.1,0.7,3,2,0.3,110,62,48,2,29,24,55,16,32,7,0.7746478873239436,0.8870967741935484,0.8270676691729323,0.7909090909090909,high_precision
Baseline,FloodFrequency,{'max_flood_count': 3},1.0,0.2,0.2,3,2,0.3,173,123,50,2,29,24,46,1,49,77,0.9787234042553191,0.37398373983739835,0.5411764705882353,0.5491329479768786,high_precision
Baseline,FloodFrequency,{'max_flood_count': 3},1.0,0.2,0.3,3,2,0.3,163,113,50,2,29,24,48,1,49,65,0.9795918367346939,0.4247787610619469,0.5925925925925926,0.5950920245398773,high_precision
Baseline,FloodFrequency,{'max_flood_count': 3},1.0,0.2,0.5,3,2,0.3,134,84,50,2,29,24,43,1,49,41,0.9772727272727273,0.5119047619047619,0.6718749999999999,0.6865671641791045,high_precision
Baseline,FloodFrequency,{'max_flood_count': 3},1.0,0.2,0.7,3,2,0.3,110,62,48,2,29,24,31,0,48,31,1.0,0.5,0.6666666666666666,0.7181818181818181,high_precision
Baseline,FloodFrequency,{'max_flood_count': 3},1.0,0.3,0.2,3,2,0.3,173,123,50,2,29,24,36,0,50,87,1.0,0.2926829268292683,0.45283018867924524,0.49710982658959535,high_precision
Baseline,FloodFrequency,{'max_flood_count': 3},1.0,0.3,0.3,3,2,0.3,163,113,50,2,29,24,35,0,50,78,1.0,0.30973451327433627,0.4729729729729729,0.5214723926380368,high_precision
Baseline,FloodFrequency,{'max_flood_count': 3},1.0,0.3,0.5,3,2,0.3,134,84,50,2,29,24,33,0,50,51,1.0,0.39285714285714285,0.5641025641025641,0.6194029850746269,high_precision
Baseline,FloodFrequency,{'max_flood_count': 3},1.0,0.3,0.7,3,2,0.3,110,62,48,2,29,24,24,0,48,38,1.0,0.3870967741935484,0.5581395348837209,0.6545454545454545,high_precision
Baseline,FloodFrequency,{'max_flood_count': 3},1.0,0.4,0.2,3,2,0.3,173,123,50,2,29,24,13,0,50,110,1.0,0.10569105691056911,0.1911764705882353,0.36416184971098264,high_precision
Baseline,FloodFrequency,{'max_flood_count': 3},1.0,0.4,0.3,3,2,0.3,163,113,50,2,29,24,15,0,50,98,1.0,0.13274336283185842,0.23437500000000003,0.3987730061349693,high_precision
Baseline,FloodFrequency,{'max_flood_count': 3},1.0,0.4,0.5,3,2,0.3,134,84,50,2,29,24,17,0,50,67,1.0,0.20238095238095238,0.33663366336633666,0.5,high_precision
Baseline,FloodFrequency,{'max_flood_count': 3},1.0,0.4,0.7,3,2,0.3,110,62,48,2,29,24,15,0,48,47,1.0,0.24193548387096775,0.38961038961038963,0.5727272727272728,high_precision
Baseline,FloodFrequency,{'max_flood_count': 3},1.0,0.5,0.3,3,2,0.3,163,113,50,2,29,24,4,0,50,109,1.0,0.035398230088495575,0.06837606837606837,0.3312883435582822,high_precision
Baseline,FloodFrequency,{'max_flood_count': 3},1.0,0.5,0.5,3,2,0.3,134,84,50,2,29,24,6,0,50,78,1.0,0.07142857142857142,0.13333333333333333,0.417910447761194,high_precision
Baseline,FloodFrequency,{'max_flood_count': 3},1.0,0.5,0.7,3,2,0.3,110,62,48,2,29,24,9,0,48,53,1.0,0.14516129032258066,0.2535211267605634,0.5181818181818182,high_precision
Baseline,FloodFrequency,{'max_flood_count': 3},2.0,0.1,0.2,3,2,0.3,181,123,58,2,29,24,100,8,50,23,0.9259259259259259,0.8130081300813008,0.8658008658008658,0.8287292817679558,high_precision
Baseline,FloodFrequency,{'max_flood_count': 3},2.0,0.1,0.3,3,2,0.3,171,113,58,2,29,24,95,9,49,18,0.9134615384615384,0.8407079646017699,0.8755760368663594,0.8421052631578947,high_precision
Baseline,FloodFrequency,{'max_flood_count': 3},2.0,0.1,0.5,3,2,0.3,142,84,58,2,29,24,76,12,46,8,0.8636363636363636,0.9047619047619048,0.8837209302325582,0.8591549295774648,high_precision
Baseline,FloodFrequency,{'max_flood_count': 3},2.0,0.1,0.7,3,2,0.3,120,62,58,2,29,24,55,17,41,7,0.7638888888888888,0.8870967741935484,0.8208955223880596,0.8,high_precision
Baseline,FloodFrequency,{'max_flood_count': 3},2.0,0.2,0.2,3,2,0.3,181,123,58,2,29,24,46,1,57,77,0.9787234042553191,0.37398373983739835,0.5411764705882353,0.569060773480663,high_precision
Baseline,FloodFrequency,{'max_flood_count': 3},2.0,0.2,0.3,3,2,0.3,171,113,58,2,29,24,48,1,57,65,0.9795918367346939,0.4247787610619469,0.5925925925925926,0.6140350877192983,high_precision
Baseline,FloodFrequency,{'max_flood_count': 3},2.0,0.2,0.5,3,2,0.3,142,84,58,2,29,24,43,1,57,41,0.9772727272727273,0.5119047619047619,0.6718749999999999,0.704225352112676,high_precision
Baseline,FloodFrequency,{'max_flood_count': 3},2.0,0.2,0.7,3,2,0.3,120,62,58,2,29,24,31,0,58,31,1.0,0.5,0.6666666666666666,0.7416666666666667,high_precision
Baseline,FloodFrequency,{'max_flood_count': 3},2.0,0.3,0.2,3,2,0.3,181,123,58,2,29,24,36,0,58,87,1.0,0.2926829268292683,0.45283018867924524,0.5193370165745856,high_precision
Baseline,FloodFrequency,{'max_flood_count': 3},2.0,0.3,0.3,3,2,0.3,171,113,58,2,29,24,35,0,58,78,1.0,0.30973451327433627,0.4729729729729729,0.543859649122807,high_precision
Baseline,FloodFrequency,{'max_flood_count': 3},2.0,0.3,0.5,3,2,0.3,142,84,58,2,29,24,33,0,58,51,1.0,0.39285714285714285,0.5641025641025641,0.6408450704225352,high_precision
Baseline,FloodFrequency,{'max_flood_count': 3},2.0,0.3,0.7,3,2,0.3,120,62,58,2,29,24,24,0,58,38,1.0,0.3870967741935484,0.5581395348837209,0.6833333333333333,high_precision
Baseline,FloodFrequency,{'max_flood_count': 3},2.0,0.4,0.2,3,2,0.3,181,123,58,2,29,24,13,0,58,110,1.0,0.10569105691056911,0.1911764705882353,0.39226519337016574,high_precision
Baseline,FloodFrequency,{'max_flood_count': 3},2.0,0.4,0.3,3,2,0.3,171,113,58,2,29,24,15,0,58,98,1.0,0.13274336283185842,0.23437500000000003,0.4269005847953216,high_precision
Baseline,FloodFrequency,{'max_flood_count': 3},2.0,0.4,0.5,3,2,0.3,142,84,58,2,29,24,17,0,58,67,1.0,0.20238095238095238,0.33663366336633666,0.528169014084507,high_precision
Baseline,FloodFrequency,{'max_flood_count': 3},2.0,0.4,0.7,3,2,0.3,120,62,58,2,29,24,15,0,58,47,1.0,0.24193548387096775,0.38961038961038963,0.6083333333333333,high_precision
Baseline,FloodFrequency,{'max_flood_count': 3},2.0,0.5,0.3,3,2,0.3,171,113,58,2,29,24,4,0,58,109,1.0,0.035398230088495575,0.06837606837606837,0.36257309941520466,high_precision
Baseline,FloodFrequency,{'max_flood_count': 3},2.0,0.5,0.5,3,2,0.3,142,84,58,2,29,24,6,0,58,78,1.0,0.07142857142857142,0.13333333333333333,0.4507042253521127,high_precision
Baseline,FloodFrequency,{'max_flood_count': 3},2.0,0.5,0.7,3,2,0.3,120,62,58,2,29,24,9,0,58,53,1.0,0.14516129032258066,0.2535211267605634,0.5583333333333333,high_precision
Baseline,RecentActivity,{'max_recent_floods': 0},1.0,0.1,0.2,3,2,0.3,235,123,112,9,29,24,100,19,93,23,0.8403361344537815,0.8130081300813008,0.8264462809917354,0.8212765957446808,high_precision
Baseline,RecentActivity,{'max_recent_floods': 0},1.0,0.1,0.3,3,2,0.3,219,113,106,9,29,24,95,21,85,18,0.8189655172413793,0.8407079646017699,0.8296943231441049,0.821917808219178,high_precision
Baseline,RecentActivity,{'max_recent_floods': 0},1.0,0.1,0.5,3,2,0.3,166,84,82,9,29,24,76,30,52,8,0.7169811320754716,0.9047619047619048,0.8,0.7710843373493976,high_precision
Baseline,RecentActivity,{'max_recent_floods': 0},1.0,0.2,0.2,3,2,0.3,235,123,112,9,29,24,46,5,107,77,0.9019607843137255,0.37398373983739835,0.5287356321839081,0.6510638297872341,high_precision
Baseline,RecentActivity,{'max_recent_floods': 0},1.0,0.2,0.3,3,2,0.3,219,113,106,9,29,24,48,8,98,65,0.8571428571428571,0.4247787610619469,0.5680473372781065,0.6666666666666666,high_precision
Baseline,RecentActivity,{'max_recent_floods': 0},1.0,0.2,0.5,3,2,0.3,166,84,82,9,29,24,43,11,71,41,0.7962962962962963,0.5119047619047619,0.6231884057971014,0.6867469879518072,high_precision
Baseline,RecentActivity,{'max_recent_floods': 0},1.0,0.2,0.7,3,2,0.3,124,62,62,9,29,24,31,8,54,31,0.7948717948717948,0.5,0.6138613861386139,0.6854838709677419,high_precision
Baseline,RecentActivity,{'max_recent_floods': 0},1.0,0.3,0.2,3,2,0.3,235,123,112,9,29,24,36,1,111,87,0.972972972972973,0.2926829268292683,0.44999999999999996,0.625531914893617,high_precision
Baseline,RecentActivity,{'max_recent_floods': 0},1.0,0.3,0.3,3,2,0.3,219,113,106,9,29,24,35,3,103,78,0.9210526315789473,0.30973451327433627,0.4635761589403973,0.6301369863013698,high_precision
Baseline,RecentActivity,{'max_recent_floods': 0},1.0,0.3,0.5,3,2,0.3,166,84,82,9,29,24,33,5,77,51,0.868421052631579,0.39285714285714285,0.5409836065573771,0.6626506024096386,high_precision
Baseline,RecentActivity,{'max_recent_floods': 0},1.0,0.3,0.7,3,2,0.3,124,62,62,9,29,24,24,7,55,38,0.7741935483870968,0.3870967741935484,0.5161290322580645,0.6370967741935484,high_precision
Baseline,RecentActivity,{'max_recent_floods': 0},1.0,0.4,0.2,3,2,0.3,235,123,112,9,29,24,13,1,111,110,0.9285714285714286,0.10569105691056911,0.18978102189781024,0.5276595744680851,high_precision
Baseline,RecentActivity,{'max_recent_floods': 0},1.0,0.4,0.3,3,2,0.3,219,113,106,9,29,24,15,3,103,98,0.8333333333333334,0.13274336283185842,0.2290076335877863,0.5388127853881278,high_precision
Baseline,RecentActivity,{'max_recent_floods': 0},1.0,0.4,0.5,3,2,0.3,166,84,82,9,29,24,17,3,79,67,0.85,0.20238095238095238,0.3269230769230769,0.5783132530120482,high_precision
Baseline,RecentActivity,{'max_recent_floods': 0},1.0,0.4,0.7,3,2,0.3,124,62,62,9,29,24,15,5,57,47,0.75,0.24193548387096775,0.36585365853658536,0.5806451612903226,high_precision
Baseline,RecentActivity,{'max_recent_floods': 0},1.0,0.5,0.7,3,2,0.3,124,62,62,9,29,24,9,3,59,53,0.75,0.14516129032258066,0.24324324324324328,0.5483870967741935,high_precision
Baseline,RecentActivity,{'max_recent_floods': 0},2.0,0.1,0.2,3,2,0.3,290,123,167,9,29,24,100,27,140,23,0.7874015748031497,0.8130081300813008,0.8,0.8275862068965517,high_precision
Baseline,RecentActivity,{'max_recent_floods': 0},2.0,0.1,0.3,3,2,0.3,280,113,167,9,29,24,95,33,134,18,0.7421875,0.8407079646017699,0.7883817427385892,0.8178571428571428,high_precision
Baseline,RecentActivity,{'max_recent_floods': 0},2.0,0.2,0.2,3,2,0.3,290,123,167,9,29,24,46,9,158,77,0.8363636363636363,0.37398373983739835,0.5168539325842697,0.7034482758620689,high_precision
Baseline,RecentActivity,{'max_recent_floods': 0},2.0,0.2,0.3,3,2,0.3,280,113,167,9,29,24,48,16,151,65,0.75,0.4247787610619469,0.5423728813559322,0.7107142857142857,high_precision
Baseline,RecentActivity,{'max_recent_floods': 0},2.0,0.3,0.2,3,2,0.3,290,123,167,9,29,24,36,2,165,87,0.9473684210526315,0.2926829268292683,0.44720496894409933,0.6931034482758621,high_precision
Baseline,RecentActivity,{'max_recent_floods': 0},2.0,0.3,0.3,3,2,0.3,280,113,167,9,29,24,35,8,159,78,0.813953488372093,0.30973451327433627,0.44871794871794873,0.6928571428571428,high_precision
Baseline,RecentActivity,{'max_recent_floods': 0},2.0,0.4,0.2,3,2,0.3,290,123,167,9,29,24,13,1,166,110,0.9285714285714286,0.10569105691056911,0.18978102189781024,0.6172413793103448,high_precision
Baseline,RecentActivity,{'max_recent_floods': 0},2.0,0.4,0.3,3,2,0.3,280,113,167,9,29,24,15,6,161,98,0.7142857142857143,0.13274336283185842,0.2238805970149254,0.6285714285714286,high_precision
Baseline,RecentActivity,{'max_recent_floods': 1},1.0,0.1,0.2,3,2,0.3,245,123,122,17,29,24,100,18,104,23,0.847457627118644,0.8130081300813008,0.8298755186721991,0.8326530612244898,high_precision
Baseline,RecentActivity,{'max_recent_floods': 1},1.0,0.1,0.3,3,2,0.3,226,113,113,17,29,24,95,21,92,18,0.8189655172413793,0.8407079646017699,0.8296943231441049,0.827433628318584,high_precision
Baseline,RecentActivity,{'max_recent_floods': 1},1.0,0.1,0.5,3,2,0.3,168,84,84,17,29,24,76,26,58,8,0.7450980392156863,0.9047619047619048,0.8172043010752689,0.7976190476190477,high_precision
Baseline,RecentActivity,{'max_recent_floods': 1},1.0,0.1,0.7,3,2,0.3,124,62,62,17,29,24,55,22,40,7,0.7142857142857143,0.8870967741935484,0.7913669064748201,0.7661290322580645,high_precision
Baseline,RecentActivity,{'max_recent_floods': 1},1.0,0.2,0.2,3,2,0.3,245,123,122,17,29,24,46,3,119,77,0.9387755102040817,0.37398373983739835,0.5348837209302325,0.673469387755102,high_precision
Baseline,RecentActivity,{'max_recent_floods': 1},1.0,0.2,0.3,3,2,0.3,226,113,113,17,29,24,48,6,107,65,0.8888888888888888,0.4247787610619469,0.5748502994011976,0.6858407079646017,high_precision
Baseline,RecentActivity,{'max_recent_floods': 1},1.0,0.2,0.5,3,2,0.3,168,84,84,17,29,24,43,7,77,41,0.86,0.5119047619047619,0.6417910447761195,0.7142857142857143,high_precision
Baseline,RecentActivity,{'max_recent_floods': 1},1.0,0.2,0.7,3,2,0.3,124,62,62,17,29,24,31,6,56,31,0.8378378378378378,0.5,0.6262626262626263,0.7016129032258065,high_precision
Baseline,RecentActivity,{'max_recent_floods': 1},1.0,0.3,0.2,3,2,0.3,245,123,122,17,29,24,36,0,122,87,1.0,0.2926829268292683,0.45283018867924524,0.6448979591836734,high_precision
Baseline,RecentActivity,{'max_recent_floods': 1},1.0,0.3,0.3,3,2,0.3,226,113,113,17,29,24,35,2,111,78,0.9459459459459459,0.30973451327433627,0.4666666666666667,0.6460176991150443,high_precision
Baseline,RecentActivity,{'max_recent_floods': 1},1.0,0.3,0.5,3,2,0.3,168,84,84,17,29,24,33,4,80,51,0.8918918918918919,0.39285714285714285,0.5454545454545454,0.6726190476190477,high_precision
Baseline,RecentActivity,{'max_recent_floods': 1},1.0,0.3,0.7,3,2,0.3,124,62,62,17,29,24,24,6,56,38,0.8,0.3870967741935484,0.5217391304347827,0.6451612903225806,high_precision
Baseline,RecentActivity,{'max_recent_floods': 1},1.0,0.4,0.2,3,2,0.3,245,123,122,17,29,24,13,0,122,110,1.0,0.10569105691056911,0.1911764705882353,0.5510204081632653,high_precision
Baseline,RecentActivity,{'max_recent_floods': 1},1.0,0.4,0.3,3,2,0.3,226,113,113,17,29,24,15,2,111,98,0.8823529411764706,0.13274336283185842,0.2307692307692308,0.5575221238938053,high_precision
Baseline,RecentActivity,{'max_recent_floods': 1},1.0,0.4,0.5,3,2,0.3,168,84,84,17,29,24,17,3,81,67,0.85,0.20238095238095238,0.3269230769230769,0.5833333333333334,high_precision
Baseline,RecentActivity,{'max_recent_floods': 1},1.0,0.4,0.7,3,2,0.3,124,62,62,17,29,24,15,4,58,47,0.7894736842105263,0.24193548387096775,0.37037037037037035,0.5887096774193549,high_precision
Baseline,RecentActivity,{'max_recent_floods': 1},1.0,0.5,0.3,3,2,0.3,226,113,113,17,29,24,4,1,112,109,0.8,0.035398230088495575,0.06779661016949151,0.5132743362831859,high_precision
Baseline,RecentActivity,{'max_recent_floods': 1},1.0,0.5,0.5,3,2,0.3,168,84,84,17,29,24,6,2,82,78,0.75,0.07142857142857142,0.13043478260869565,0.5238095238095238,high_precision
Baseline,RecentActivity,{'max_recent_floods': 1},1.0,0.5,0.7,3,2,0.3,124,62,62,17,29,24,9,3,59,53,0.75,0.14516129032258066,0.24324324324324328,0.5483870967741935,high_precision
Baseline,RecentActivity,{'max_recent_floods': 1},2.0,0.2,0.2,3,2,0.3,343,123,220,17,29,24,46,9,211,77,0.8363636363636363,0.37398373983739835,0.5168539325842697,0.749271137026239,high_precision
Baseline,RecentActivity,{'max_recent_floods': 1},2.0,0.2,0.3,3,2,0.3,323,113,210,17,29,24,48,19,191,65,0.7164179104477612,0.4247787610619469,0.5333333333333332,0.739938080495356,high_precision
Baseline,RecentActivity,{'max_recent_floods': 1},2.0,0.3,0.2,3,2,0.3,343,123,220,17,29,24,36,3,217,87,0.9230769230769231,0.2926829268292683,0.4444444444444444,0.7376093294460642,high_precision
Baseline,RecentActivity,{'max_recent_floods': 1},2.0,0.3,0.3,3,2,0.3,323,113,210,17,29,24,35,12,198,78,0.7446808510638298,0.30973451327433627,0.4375,0.7213622291021672,high_precision
Baseline,RecentActivity,{'max_recent_floods': 1},2.0,0.4,0.2,3,2,0.3,343,123,220,17,29,24,13,1,219,110,0.9285714285714286,0.10569105691056911,0.18978102189781024,0.6763848396501457,high_precision
Baseline,RecentActivity,{'max_recent_floods': 2},1.0,0.1,0.2,3,2,0.3,246,123,123,22,29,24,100,18,105,23,0.847457627118644,0.8130081300813008,0.8298755186721991,0.8333333333333334,high_precision
Baseline,RecentActivity,{'max_recent_floods': 2},1.0,0.1,0.3,3,2,0.3,226,113,113,22,29,24,95,19,94,18,0.8333333333333334,0.8407079646017699,0.8370044052863437,0.8362831858407079,high_precision
Baseline,RecentActivity,{'max_recent_floods': 2},1.0,0.1,0.5,3,2,0.3,168,84,84,22,29,24,76,25,59,8,0.7524752475247525,0.9047619047619048,0.8216216216216216,0.8035714285714286,high_precision
Baseline,RecentActivity,{'max_recent_floods': 2},1.0,0.1,0.7,3,2,0.3,124,62,62,22,29,24,55,22,40,7,0.7142857142857143,0.8870967741935484,0.7913669064748201,0.7661290322580645,high_precision
Baseline,RecentActivity,{'max_recent_floods': 2},1.0,0.2,0.2,3,2,0.3,246,123,123,22,29,24,46,3,120,77,0.9387755102040817,0.37398373983739835,0.5348837209302325,0.6747967479674797,high_precision
Baseline,RecentActivity,{'max_recent_floods': 2},1.0,0.2,0.3,3,2,0.3,226,113,113,22,29,24,48,6,107,65,0.8888888888888888,0.4247787610619469,0.5748502994011976,0.6858407079646017,high_precision
Baseline,RecentActivity,{'max_recent_floods': 2},1.0,0.2,0.5,3,2,0.3,168,84,84,22,29,24,43,6,78,41,0.8775510204081632,0.5119047619047619,0.6466165413533834,0.7202380952380952,high_precision
Baseline,RecentActivity,{'max_recent_floods': 2},1.0,0.2,0.7,3,2,0.3,124,62,62,22,29,24,31,6,56,31,0.8378378378378378,0.5,0.6262626262626263,0.7016129032258065,high_precision
Baseline,RecentActivity,{'max_recent_floods': 2},1.0,0.3,0.2,3,2,0.3,246,123,123,22,29,24,36,0,123,87,1.0,0.2926829268292683,0.45283018867924524,0.6463414634146342,high_precision
Baseline,RecentActivity,{'max_recent_floods': 2},1.0,0.3,0.3,3,2,0.3,226,113,113,22,29,24,35,2,111,78,0.9459459459459459,0.30973451327433627,0.4666666666666667,0.6460176991150443,high_precision
Baseline,RecentActivity,{'max_recent_floods': 2},1.0,0.3,0.5,3,2,0.3,168,84,84,22,29,24,33,3,81,51,0.9166666666666666,0.39285714285714285,0.55,0.6785714285714286,high_precision
Baseline,RecentActivity,{'max_recent_floods': 2},1.0,0.3,0.7,3,2,0.3,124,62,62,22,29,24,24,6,56,38,0.8,0.3870967741935484,0.5217391304347827,0.6451612903225806,high_precision
Baseline,RecentActivity,{'max_recent_floods': 2},1.0,0.4,0.2,3,2,0.3,246,123,123,22,29,24,13,0,123,110,1.0,0.10569105691056911,0.1911764705882353,0.5528455284552846,high_precision
Baseline,RecentActivity,{'max_recent_floods': 2},1.0,0.4,0.3,3,2,0.3,226,113,113,22,29,24,15,2,111,98,0.8823529411764706,0.13274336283185842,0.2307692307692308,0.5575221238938053,high_precision
Baseline,RecentActivity,{'max_recent_floods': 2},1.0,0.4,0.5,3,2,0.3,168,84,84,22,29,24,17,2,82,67,0.8947368421052632,0.20238095238095238,0.33009708737864074,0.5892857142857143,high_precision
Baseline,RecentActivity,{'max_recent_floods': 2},1.0,0.4,0.7,3,2,0.3,124,62,62,22,29,24,15,4,58,47,0.7894736842105263,0.24193548387096775,0.37037037037037035,0.5887096774193549,high_precision
Baseline,RecentActivity,{'max_recent_floods': 2},1.0,0.5,0.3,3,2,0.3,226,113,113,22,29,24,4,1,112,109,0.8,0.035398230088495575,0.06779661016949151,0.5132743362831859,high_precision
Baseline,RecentActivity,{'max_recent_floods': 2},1.0,0.5,0.5,3,2,0.3,168,84,84,22,29,24,6,1,83,78,0.8571428571428571,0.07142857142857142,0.13186813186813187,0.5297619047619048,high_precision
Baseline,RecentActivity,{'max_recent_floods': 2},1.0,0.5,0.7,3,2,0.3,124,62,62,22,29,24,9,3,59,53,0.75,0.14516129032258066,0.24324324324324328,0.5483870967741935,high_precision
Baseline,RecentActivity,{'max_recent_floods': 2},2.0,0.2,0.2,3,2,0.3,353,123,230,22,29,24,46,9,221,77,0.8363636363636363,0.37398373983739835,0.5168539325842697,0.7563739376770539,high_precision
Baseline,RecentActivity,{'max_recent_floods': 2},2.0,0.2,0.3,3,2,0.3,330,113,217,22,29,24,48,17,200,65,0.7384615384615385,0.4247787610619469,0.5393258426966292,0.7515151515151515,high_precision
Baseline,RecentActivity,{'max_recent_floods': 2},2.0,0.3,0.2,3,2,0.3,353,123,230,22,29,24,36,3,227,87,0.9230769230769231,0.2926829268292683,0.4444444444444444,0.7450424929178471,high_precision
Baseline,RecentActivity,{'max_recent_floods': 2},2.0,0.3,0.3,3,2,0.3,330,113,217,22,29,24,35,12,205,78,0.7446808510638298,0.30973451327433627,0.4375,0.7272727272727273,high_precision
Baseline,RecentActivity,{'max_recent_floods': 2},2.0,0.4,0.2,3,2,0.3,353,123,230,22,29,24,13,1,229,110,0.9285714285714286,0.10569105691056911,0.18978102189781024,0.6855524079320113,high_precision
Baseline,CombinedConservative,"{'prob_threshold': 0.15, 'max_flood_count': 3, 'max_recent_floods': 2}",1.0,0.1,0.2,3,2,0.3,173,123,50,2,29,24,100,7,43,23,0.9345794392523364,0.8130081300813008,0.8695652173913043,0.8265895953757225,high_precision
Baseline,CombinedConservative,"{'prob_threshold': 0.15, 'max_flood_count': 3, 'max_recent_floods': 2}",1.0,0.1,0.3,3,2,0.3,163,113,50,2,29,24,95,8,42,18,0.9223300970873787,0.8407079646017699,0.8796296296296297,0.8404907975460123,high_precision
Baseline,CombinedConservative,"{'prob_threshold': 0.15, 'max_flood_count': 3, 'max_recent_floods': 2}",1.0,0.1,0.5,3,2,0.3,134,84,50,2,29,24,76,11,39,8,0.8735632183908046,0.9047619047619048,0.8888888888888888,0.8582089552238806,high_precision
Baseline,CombinedConservative,"{'prob_threshold': 0.15, 'max_flood_count': 3, 'max_recent_floods': 2}",1.0,0.1,0.7,3,2,0.3,110,62,48,2,29,24,55,16,32,7,0.7746478873239436,0.8870967741935484,0.8270676691729323,0.7909090909090909,high_precision
Baseline,CombinedConservative,"{'prob_threshold': 0.15, 'max_flood_count': 3, 'max_recent_floods': 2}",1.0,0.2,0.2,3,2,0.3,173,123,50,2,29,24,46,1,49,77,0.9787234042553191,0.37398373983739835,0.5411764705882353,0.5491329479768786,high_precision
Baseline,CombinedConservative,"{'prob_threshold': 0.15, 'max_flood_count': 3, 'max_recent_floods': 2}",1.0,0.2,0.3,3,2,0.3,163,113,50,2,29,24,48,1,49,65,0.9795918367346939,0.4247787610619469,0.5925925925925926,0.5950920245398773,high_precision
Baseline,CombinedConservative,"{'prob_threshold': 0.15, 'max_flood_count': 3, 'max_recent_floods': 2}",1.0,0.2,0.5,3,2,0.3,134,84,50,2,29,24,43,1,49,41,0.9772727272727273,0.5119047619047619,0.6718749999999999,0.6865671641791045,high_precision
Baseline,CombinedConservative,"{'prob_threshold': 0.15, 'max_flood_count': 3, 'max_recent_floods': 2}",1.0,0.2,0.7,3,2,0.3,110,62,48,2,29,24,31,0,48,31,1.0,0.5,0.6666666666666666,0.7181818181818181,high_precision
Baseline,CombinedConservative,"{'prob_threshold': 0.15, 'max_flood_count': 3, 'max_recent_floods': 2}",1.0,0.3,0.2,3,2,0.3,173,123,50,2,29,24,36,0,50,87,1.0,0.2926829268292683,0.45283018867924524,0.49710982658959535,high_precision
Baseline,CombinedConservative,"{'prob_threshold': 0.15, 'max_flood_count': 3, 'max_recent_floods': 2}",1.0,0.3,0.3,3,2,0.3,163,113,50,2,29,24,35,0,50,78,1.0,0.30973451327433627,0.4729729729729729,0.5214723926380368,high_precision
Baseline,CombinedConservative,"{'prob_threshold': 0.15, 'max_flood_count': 3, 'max_recent_floods': 2}",1.0,0.3,0.5,3,2,0.3,134,84,50,2,29,24,33,0,50,51,1.0,0.39285714285714285,0.5641025641025641,0.6194029850746269,high_precision
Baseline,CombinedConservative,"{'prob_threshold': 0.15, 'max_flood_count': 3, 'max_recent_floods': 2}",1.0,0.3,0.7,3,2,0.3,110,62,48,2,29,24,24,0,48,38,1.0,0.3870967741935484,0.5581395348837209,0.6545454545454545,high_precision
Baseline,CombinedConservative,"{'prob_threshold': 0.15, 'max_flood_count': 3, 'max_recent_floods': 2}",1.0,0.4,0.2,3,2,0.3,173,123,50,2,29,24,13,0,50,110,1.0,0.10569105691056911,0.1911764705882353,0.36416184971098264,high_precision
Baseline,CombinedConservative,"{'prob_threshold': 0.15, 'max_flood_count': 3, 'max_recent_floods': 2}",1.0,0.4,0.3,3,2,0.3,163,113,50,2,29,24,15,0,50,98,1.0,0.13274336283185842,0.23437500000000003,0.3987730061349693,high_precision
Baseline,CombinedConservative,"{'prob_threshold': 0.15, 'max_flood_count': 3, 'max_recent_floods': 2}",1.0,0.4,0.5,3,2,0.3,134,84,50,2,29,24,17,0,50,67,1.0,0.20238095238095238,0.33663366336633666,0.5,high_precision
Baseline,CombinedConservative,"{'prob_threshold': 0.15, 'max_flood_count': 3, 'max_recent_floods': 2}",1.0,0.4,0.7,3,2,0.3,110,62,48,2,29,24,15,0,48,47,1.0,0.24193548387096775,0.38961038961038963,0.5727272727272728,high_precision
Baseline,CombinedConservative,"{'prob_threshold': 0.15, 'max_flood_count': 3, 'max_recent_floods': 2}",1.0,0.5,0.3,3,2,0.3,163,113,50,2,29,24,4,0,50,109,1.0,0.035398230088495575,0.06837606837606837,0.3312883435582822,high_precision
Baseline,CombinedConservative,"{'prob_threshold': 0.15, 'max_flood_count': 3, 'max_recent_floods': 2}",1.0,0.5,0.5,3,2,0.3,134,84,50,2,29,24,6,0,50,78,1.0,0.07142857142857142,0.13333333333333333,0.417910447761194,high_precision
Baseline,CombinedConservative,"{'prob_threshold': 0.15, 'max_flood_count': 3, 'max_recent_floods': 2}",1.0,0.5,0.7,3,2,0.3,110,62,48,2,29,24,9,0,48,53,1.0,0.14516129032258066,0.2535211267605634,0.5181818181818182,high_precision
Baseline,CombinedConservative,"{'prob_threshold': 0.15, 'max_flood_count': 3, 'max_recent_floods': 2}",2.0,0.1,0.2,3,2,0.3,181,123,58,2,29,24,100,8,50,23,0.9259259259259259,0.8130081300813008,0.8658008658008658,0.8287292817679558,high_precision
Baseline,CombinedConservative,"{'prob_threshold': 0.15, 'max_flood_count': 3, 'max_recent_floods': 2}",2.0,0.1,0.3,3,2,0.3,171,113,58,2,29,24,95,9,49,18,0.9134615384615384,0.8407079646017699,0.8755760368663594,0.8421052631578947,high_precision
Baseline,CombinedConservative,"{'prob_threshold': 0.15, 'max_flood_count': 3, 'max_recent_floods': 2}",2.0,0.1,0.5,3,2,0.3,142,84,58,2,29,24,76,12,46,8,0.8636363636363636,0.9047619047619048,0.8837209302325582,0.8591549295774648,high_precision
Baseline,CombinedConservative,"{'prob_threshold': 0.15, 'max_flood_count': 3, 'max_recent_floods': 2}",2.0,0.1,0.7,3,2,0.3,120,62,58,2,29,24,55,17,41,7,0.7638888888888888,0.8870967741935484,0.8208955223880596,0.8,high_precision
Baseline,CombinedConservative,"{'prob_threshold': 0.15, 'max_flood_count': 3, 'max_recent_floods': 2}",2.0,0.2,0.2,3,2,0.3,181,123,58,2,29,24,46,1,57,77,0.9787234042553191,0.37398373983739835,0.5411764705882353,0.569060773480663,high_precision
Baseline,CombinedConservative,"{'prob_threshold': 0.15, 'max_flood_count': 3, 'max_recent_floods': 2}",2.0,0.2,0.3,3,2,0.3,171,113,58,2,29,24,48,1,57,65,0.9795918367346939,0.4247787610619469,0.5925925925925926,0.6140350877192983,high_precision
Baseline,CombinedConservative,"{'prob_threshold': 0.15, 'max_flood_count': 3, 'max_recent_floods': 2}",2.0,0.2,0.5,3,2,0.3,142,84,58,2,29,24,43,1,57,41,0.9772727272727273,0.5119047619047619,0.6718749999999999,0.704225352112676,high_precision
Baseline,CombinedConservative,"{'prob_threshold': 0.15, 'max_flood_count': 3, 'max_recent_floods': 2}",2.0,0.2,0.7,3,2,0.3,120,62,58,2,29,24,31,0,58,31,1.0,0.5,0.6666666666666666,0.7416666666666667,high_precision
Baseline,CombinedConservative,"{'prob_threshold': 0.15, 'max_flood_count': 3, 'max_recent_floods': 2}",2.0,0.3,0.2,3,2,0.3,181,123,58,2,29,24,36,0,58,87,1.0,0.2926829268292683,0.45283018867924524,0.5193370165745856,high_precision
Baseline,CombinedConservative,"{'prob_threshold': 0.15, 'max_flood_count': 3, 'max_recent_floods': 2}",2.0,0.3,0.3,3,2,0.3,171,113,58,2,29,24,35,0,58,78,1.0,0.30973451327433627,0.4729729729729729,0.543859649122807,high_precision
Baseline,CombinedConservative,"{'prob_threshold': 0.15, 'max_flood_count': 3, 'max_recent_floods': 2}",2.0,0.3,0.5,3,2,0.3,142,84,58,2,29,24,33,0,58,51,1.0,0.39285714285714285,0.5641025641025641,0.6408450704225352,high_precision
Baseline,CombinedConservative,"{'prob_threshold': 0.15, 'max_flood_count': 3, 'max_recent_floods': 2}",2.0,0.3,0.7,3,2,0.3,120,62,58,2,29,24,24,0,58,38,1.0,0.3870967741935484,0.5581395348837209,0.6833333333333333,high_precision
Baseline,CombinedConservative,"{'prob_threshold': 0.15, 'max_flood_count': 3, 'max_recent_floods': 2}",2.0,0.4,0.2,3,2,0.3,181,123,58,2,29,24,13,0,58,110,1.0,0.10569105691056911,0.1911764705882353,0.39226519337016574,high_precision
Baseline,CombinedConservative,"{'prob_threshold': 0.15, 'max_flood_count': 3, 'max_recent_floods': 2}",2.0,0.4,0.3,3,2,0.3,171,113,58,2,29,24,15,0,58,98,1.0,0.13274336283185842,0.23437500000000003,0.4269005847953216,high_precision
Baseline,CombinedConservative,"{'prob_threshold': 0.15, 'max_flood_count': 3, 'max_recent_floods': 2}",2.0,0.4,0.5,3,2,0.3,142,84,58,2,29,24,17,0,58,67,1.0,0.20238095238095238,0.33663366336633666,0.528169014084507,high_precision
Baseline,CombinedConservative,"{'prob_threshold': 0.15, 'max_flood_count': 3, 'max_recent_floods': 2}",2.0,0.4,0.7,3,2,0.3,120,62,58,2,29,24,15,0,58,47,1.0,0.24193548387096775,0.38961038961038963,0.6083333333333333,high_precision
Baseline,CombinedConservative,"{'prob_threshold': 0.15, 'max_flood_count': 3, 'max_recent_floods': 2}",2.0,0.5,0.3,3,2,0.3,171,113,58,2,29,24,4,0,58,109,1.0,0.035398230088495575,0.06837606837606837,0.36257309941520466,high_precision
Baseline,CombinedConservative,"{'prob_threshold': 0.15, 'max_flood_count': 3, 'max_recent_floods': 2}",2.0,0.5,0.5,3,2,0.3,142,84,58,2,29,24,6,0,58,78,1.0,0.07142857142857142,0.13333333333333333,0.4507042253521127,high_precision
Baseline,CombinedConservative,"{'prob_threshold': 0.15, 'max_flood_count': 3, 'max_recent_floods': 2}",2.0,0.5,0.7,3,2,0.3,120,62,58,2,29,24,9,0,58,53,1.0,0.14516129032258066,0.2535211267605634,0.5583333333333333,high_precision
Restrictive,MarginalProbability,{'prob_threshold': 0.05},1.0,0.1,0.2,4,3,0.4,209,115,94,6,28,25,104,23,71,11,0.8188976377952756,0.9043478260869565,0.859504132231405,0.8373205741626795,high_precision
Restrictive,MarginalProbability,{'prob_threshold': 0.05},1.0,0.1,0.3,4,3,0.4,199,107,92,6,28,25,99,28,64,8,0.7795275590551181,0.9252336448598131,0.8461538461538461,0.8190954773869347,high_precision
Restrictive,MarginalProbability,{'prob_threshold': 0.05},1.0,0.2,0.2,4,3,0.4,209,115,94,6,28,25,54,3,91,61,0.9473684210526315,0.46956521739130436,0.627906976744186,0.69377990430622,high_precision
Restrictive,MarginalProbability,{'prob_threshold': 0.05},1.0,0.2,0.3,4,3,0.4,199,107,92,6,28,25,54,7,85,53,0.8852459016393442,0.5046728971962616,0.6428571428571428,0.6984924623115578,high_precision
Restrictive,MarginalProbability,{'prob_threshold': 0.05},1.0,0.2,0.5,4,3,0.4,156,79,77,6,28,25,54,16,61,25,0.7714285714285715,0.6835443037974683,0.7248322147651006,0.7371794871794872,high_precision
Restrictive,MarginalProbability,{'prob_threshold': 0.05},1.0,0.3,0.2,4,3,0.4,209,115,94,6,28,25,36,3,91,79,0.9230769230769231,0.3130434782608696,0.4675324675324676,0.6076555023923444,high_precision
Restrictive,MarginalProbability,{'prob_threshold': 0.05},1.0,0.3,0.3,4,3,0.4,199,107,92,6,28,25,36,4,88,71,0.9,0.3364485981308411,0.4897959183673469,0.6231155778894473,high_precision
Restrictive,MarginalProbability,{'prob_threshold': 0.05},1.0,0.3,0.5,4,3,0.4,156,79,77,6,28,25,35,11,66,44,0.7608695652173914,0.4430379746835443,0.5599999999999999,0.6474358974358975,high_precision
Restrictive,MarginalProbability,{'prob_threshold': 0.05},1.0,0.4,0.2,4,3,0.4,209,115,94,6,28,25,16,1,93,99,0.9411764705882353,0.1391304347826087,0.24242424242424238,0.5215311004784688,high_precision
Restrictive,MarginalProbability,{'prob_threshold': 0.05},1.0,0.4,0.3,4,3,0.4,199,107,92,6,28,25,19,2,90,88,0.9047619047619048,0.17757009345794392,0.296875,0.5477386934673367,high_precision
Restrictive,MarginalProbability,{'prob_threshold': 0.05},1.0,0.4,0.5,4,3,0.4,156,79,77,6,28,25,20,7,70,59,0.7407407407407407,0.25316455696202533,0.37735849056603776,0.5769230769230769,high_precision
Restrictive,MarginalProbability,{'prob_threshold': 0.05},1.0,0.5,0.2,4,3,0.4,209,115,94,6,28,25,1,0,94,114,1.0,0.008695652173913044,0.017241379310344827,0.45454545454545453,high_precision
Restrictive,MarginalProbability,{'prob_threshold': 0.05},1.0,0.5,0.5,4,3,0.4,156,79,77,6,28,25,6,2,75,73,0.75,0.0759493670886076,0.13793103448275862,0.5192307692307693,high_precision
Restrictive,MarginalProbability,{'prob_threshold': 0.05},2.0,0.1,0.2,4,3,0.4,246,115,131,6,28,25,104,27,104,11,0.7938931297709924,0.9043478260869565,0.8455284552845528,0.8455284552845529,high_precision
Restrictive,MarginalProbability,{'prob_threshold': 0.05},2.0,0.1,0.3,4,3,0.4,238,107,131,6,28,25,99,32,99,8,0.7557251908396947,0.9252336448598131,0.8319327731092436,0.8319327731092437,high_precision
Restrictive,MarginalProbability,{'prob_threshold': 0.05},2.0,0.2,0.2,4,3,0.4,246,115,131,6,28,25,54,4,127,61,0.9310344827586207,0.46956521739130436,0.6242774566473989,0.7357723577235772,high_precision
Restrictive,MarginalProbability,{'prob_threshold': 0.05},2.0,0.2,0.3,4,3,0.4,238,107,131,6,28,25,54,8,123,53,0.8709677419354839,0.5046728971962616,0.6390532544378698,0.7436974789915967,high_precision
Restrictive,MarginalProbability,{'prob_threshold': 0.05},2.0,0.2,0.5,4,3,0.4,200,79,121,6,28,25,54,19,102,25,0.7397260273972602,0.6835443037974683,0.7105263157894737,0.78,high_precision
Restrictive,MarginalProbability,{'prob_threshold': 0.05},2.0,0.3,0.2,4,3,0.4,246,115,131,6,28,25,36,3,128,79,0.9230769230769231,0.3130434782608696,0.4675324675324676,0.6666666666666666,high_precision
Restrictive,MarginalProbability,{'prob_threshold': 0.05},2.0,0.3,0.3,4,3,0.4,238,107,131,6,28,25,36,4,127,71,0.9,0.3364485981308411,0.4897959183673469,0.6848739495798319,high_precision
Restrictive,MarginalProbability,{'prob_threshold': 0.05},2.0,0.3,0.5,4,3,0.4,200,79,121,6,28,25,35,12,109,44,0.7446808510638298,0.4430379746835443,0.5555555555555555,0.72,high_precision
Restrictive,MarginalProbability,{'prob_threshold': 0.05},2.0,0.4,0.2,4,3,0.4,246,115,131,6,28,25,16,1,130,99,0.9411764705882353,0.1391304347826087,0.24242424242424238,0.5934959349593496,high_precision
Restrictive,MarginalProbability,{'prob_threshold': 0.05},2.0,0.4,0.3,4,3,0.4,238,107,131,6,28,25,19,2,129,88,0.9047619047619048,0.17757009345794392,0.296875,0.6218487394957983,high_precision
Restrictive,MarginalProbability,{'prob_threshold': 0.05},2.0,0.4,0.5,4,3,0.4,200,79,121,6,28,25,20,8,113,59,0.7142857142857143,0.25316455696202533,0.3738317757009346,0.665,high_precision
Restrictive,MarginalProbability,{'prob_threshold': 0.05},2.0,0.5,0.2,4,3,0.4,246,115,131,6,28,25,1,0,131,114,1.0,0.008695652173913044,0.017241379310344827,0.5365853658536586,high_precision
Restrictive,MarginalProbability,{'prob_threshold': 0.1},1.0,0.1,0.2,4,3,0.4,230,115,115,19,28,25,104,27,88,11,0.7938931297709924,0.9043478260869565,0.8455284552845528,0.8347826086956521,high_precision
Restrictive,MarginalProbability,{'prob_threshold': 0.1},1.0,0.1,0.3,4,3,0.4,214,107,107,19,28,25,99,29,78,8,0.7734375,0.9252336448598131,0.8425531914893617,0.8271028037383178,high_precision
Restrictive,MarginalProbability,{'prob_threshold': 0.1},1.0,0.2,0.2,4,3,0.4,230,115,115,19,28,25,54,3,112,61,0.9473684210526315,0.46956521739130436,0.627906976744186,0.7217391304347827,high_precision
Restrictive,MarginalProbability,{'prob_threshold': 0.1},1.0,0.2,0.3,4,3,0.4,214,107,107,19,28,25,54,7,100,53,0.8852459016393442,0.5046728971962616,0.6428571428571428,0.719626168224299,high_precision
Restrictive,MarginalProbability,{'prob_threshold': 0.1},1.0,0.2,0.5,4,3,0.4,158,79,79,19,28,25,54,16,63,25,0.7714285714285715,0.6835443037974683,0.7248322147651006,0.740506329113924,high_precision
Restrictive,MarginalProbability,{'prob_threshold': 0.1},1.0,0.3,0.2,4,3,0.4,230,115,115,19,28,25,36,3,112,79,0.9230769230769231,0.3130434782608696,0.4675324675324676,0.6434782608695652,high_precision
Restrictive,MarginalProbability,{'prob_threshold': 0.1},1.0,0.3,0.3,4,3,0.4,214,107,107,19,28,25,36,4,103,71,0.9,0.3364485981308411,0.4897959183673469,0.6495327102803738,high_precision
Restrictive,MarginalProbability,{'prob_threshold': 0.1},1.0,0.3,0.5,4,3,0.4,158,79,79,19,28,25,35,11,68,44,0.7608695652173914,0.4430379746835443,0.5599999999999999,0.6518987341772152,high_precision
Restrictive,MarginalProbability,{'prob_threshold': 0.1},1.0,0.4,0.2,4,3,0.4,230,115,115,19,28,25,16,1,114,99,0.9411764705882353,0.1391304347826087,0.24242424242424238,0.5652173913043478,high_precision
Restrictive,MarginalProbability,{'prob_threshold': 0.1},1.0,0.4,0.3,4,3,0.4,214,107,107,19,28,25,19,2,105,88,0.9047619047619048,0.17757009345794392,0.296875,0.5794392523364486,high_precision
Restrictive,MarginalProbability,{'prob_threshold': 0.1},1.0,0.4,0.5,4,3,0.4,158,79,79,19,28,25,20,7,72,59,0.7407407407407407,0.25316455696202533,0.37735849056603776,0.5822784810126582,high_precision
Restrictive,MarginalProbability,{'prob_threshold': 0.1},1.0,0.5,0.2,4,3,0.4,230,115,115,19,28,25,1,0,115,114,1.0,0.008695652173913044,0.017241379310344827,0.5043478260869565,high_precision
Restrictive,MarginalProbability,{'prob_threshold': 0.1},1.0,0.5,0.5,4,3,0.4,158,79,79,19,28,25,6,2,77,73,0.75,0.0759493670886076,0.13793103448275862,0.5253164556962026,high_precision
Restrictive,MarginalProbability,{'prob_threshold': 0.1},2.0,0.2,0.2,4,3,0.4,330,115,215,19,28,25,54,10,205,61,0.84375,0.46956521739130436,0.6033519553072626,0.7848484848484848,high_precision
Restrictive,MarginalProbability,{'prob_threshold': 0.1},2.0,0.2,0.3,4,3,0.4,312,107,205,19,28,25,54,14,191,53,0.7941176470588235,0.5046728971962616,0.6171428571428571,0.7852564102564102,high_precision
Restrictive,MarginalProbability,{'prob_threshold': 0.1},2.0,0.3,0.2,4,3,0.4,330,115,215,19,28,25,36,5,210,79,0.8780487804878049,0.3130434782608696,0.4615384615384615,0.7454545454545455,high_precision
Restrictive,MarginalProbability,{'prob_threshold': 0.1},2.0,0.3,0.3,4,3,0.4,312,107,205,19,28,25,36,6,199,71,0.8571428571428571,0.3364485981308411,0.4832214765100671,0.7532051282051282,high_precision
Restrictive,MarginalProbability,{'prob_threshold': 0.1},2.0,0.4,0.2,4,3,0.4,330,115,215,19,28,25,16,1,214,99,0.9411764705882353,0.1391304347826087,0.24242424242424238,0.696969696969697,high_precision
Restrictive,MarginalProbability,{'prob_threshold': 0.1},2.0,0.4,0.3,4,3,0.4,312,107,205,19,28,25,19,3,202,88,0.8636363636363636,0.17757009345794392,0.2945736434108527,0.7083333333333334,high_precision
Restrictive,MarginalProbability,{'prob_threshold': 0.1},2.0,0.5,0.2,4,3,0.4,330,115,215,19,28,25,1,0,215,114,1.0,0.008695652173913044,0.017241379310344827,0.6545454545454545,high_precision
Restrictive,MarginalProbability,{'prob_threshold': 0.15},1.0,0.1,0.2,4,3,0.4,230,115,115,26,28,25,104,27,88,11,0.7938931297709924,0.9043478260869565,0.8455284552845528,0.8347826086956521,high_precision
Restrictive,MarginalProbability,{'prob_threshold': 0.15},1.0,0.1,0.3,4,3,0.4,214,107,107,26,28,25,99,29,78,8,0.7734375,0.9252336448598131,0.8425531914893617,0.8271028037383178,high_precision
Restrictive,MarginalProbability,{'prob_threshold': 0.15},1.0,0.2,0.2,4,3,0.4,230,115,115,26,28,25,54,3,112,61,0.9473684210526315,0.46956521739130436,0.627906976744186,0.7217391304347827,high_precision
Restrictive,MarginalProbability,{'prob_threshold': 0.15},1.0,0.2,0.3,4,3,0.4,214,107,107,26,28,25,54,7,100,53,0.8852459016393442,0.5046728971962616,0.6428571428571428,0.719626168224299,high_precision
Restrictive,MarginalProbability,{'prob_threshold': 0.15},1.0,0.2,0.5,4,3,0.4,158,79,79,26,28,25,54,16,63,25,0.7714285714285715,0.6835443037974683,0.7248322147651006,0.740506329113924,high_precision
Restrictive,MarginalProbability,{'prob_threshold': 0.15},1.0,0.3,0.2,4,3,0.4,230,115,115,26,28,25,36,3,112,79,0.9230769230769231,0.3130434782608696,0.4675324675324676,0.6434782608695652,high_precision
Restrictive,MarginalProbability,{'prob_threshold': 0.15},1.0,0.3,0.3,4,3,0.4,214,107,107,26,28,25,36,4,103,71,0.9,0.3364485981308411,0.4897959183673469,0.6495327102803738,high_precision
Restrictive,MarginalProbability,{'prob_threshold': 0.15},1.0,0.3,0.5,4,3,0.4,158,79,79,26,28,25,35,11,68,44,0.7608695652173914,0.4430379746835443,0.5599999999999999,0.6518987341772152,high_precision
Restrictive,MarginalProbability,{'prob_threshold': 0.15},1.0,0.4,0.2,4,3,0.4,230,115,115,26,28,25,16,1,114,99,0.9411764705882353,0.1391304347826087,0.24242424242424238,0.5652173913043478,high_precision
Restrictive,MarginalProbability,{'prob_threshold': 0.15},1.0,0.4,0.3,4,3,0.4,214,107,107,26,28,25,19,2,105,88,0.9047619047619048,0.17757009345794392,0.296875,0.5794392523364486,high_precision
Restrictive,MarginalProbability,{'prob_threshold': 0.15},1.0,0.4,0.5,4,3,0.4,158,79,79,26,28,25,20,7,72,59,0.7407407407407407,0.25316455696202533,0.37735849056603776,0.5822784810126582,high_precision
Restrictive,MarginalProbability,{'prob_threshold': 0.15},1.0,0.5,0.2,4,3,0.4,230,115,115,26,28,25,1,0,115,114,1.0,0.008695652173913044,0.017241379310344827,0.5043478260869565,high_precision
Restrictive,MarginalProbability,{'prob_threshold': 0.15},1.0,0.5,0.5,4,3,0.4,158,79,79,26,28,25,6,2,77,73,0.75,0.0759493670886076,0.13793103448275862,0.5253164556962026,high_precision
Restrictive,MarginalProbability,{'prob_threshold': 0.15},2.0,0.2,0.2,4,3,0.4,343,115,228,26,28,25,54,12,216,61,0.8181818181818182,0.46956521739130436,0.5966850828729282,0.7871720116618076,high_precision
Restrictive,MarginalProbability,{'prob_threshold': 0.15},2.0,0.2,0.3,4,3,0.4,321,107,214,26,28,25,54,17,197,53,0.7605633802816901,0.5046728971962616,0.6067415730337078,0.7819314641744548,high_precision
Restrictive,MarginalProbability,{'prob_threshold': 0.15},2.0,0.3,0.2,4,3,0.4,343,115,228,26,28,25,36,5,223,79,0.8780487804878049,0.3130434782608696,0.4615384615384615,0.7551020408163265,high_precision
Restrictive,MarginalProbability,{'prob_threshold': 0.15},2.0,0.3,0.3,4,3,0.4,321,107,214,26,28,25,36,7,207,71,0.8372093023255814,0.3364485981308411,0.48000000000000004,0.7570093457943925,high_precision
Restrictive,MarginalProbability,{'prob_threshold': 0.15},2.0,0.4,0.2,4,3,0.4,343,115,228,26,28,25,16,1,227,99,0.9411764705882353,0.1391304347826087,0.24242424242424238,0.7084548104956269,high_precision
Restrictive,MarginalProbability,{'prob_threshold': 0.15},2.0,0.4,0.3,4,3,0.4,321,107,214,26,28,25,19,4,210,88,0.8260869565217391,0.17757009345794392,0.2923076923076923,0.7133956386292835,high_precision
Restrictive,MarginalProbability,{'prob_threshold': 0.15},2.0,0.5,0.2,4,3,0.4,343,115,228,26,28,25,1,0,228,114,1.0,0.008695652173913044,0.017241379310344827,0.6676384839650146,high_precision
Restrictive,RecentActivity,{'max_recent_floods': 0},1.0,0.1,0.2,4,3,0.4,191,115,76,4,28,25,104,21,55,11,0.832,0.9043478260869565,0.8666666666666667,0.8324607329842932,high_precision
Restrictive,RecentActivity,{'max_recent_floods': 0},1.0,0.1,0.3,4,3,0.4,183,107,76,4,28,25,99,26,50,8,0.792,0.9252336448598131,0.8534482758620691,0.8142076502732241,high_precision
Restrictive,RecentActivity,{'max_recent_floods': 0},1.0,0.2,0.2,4,3,0.4,191,115,76,4,28,25,54,4,72,61,0.9310344827586207,0.46956521739130436,0.6242774566473989,0.6596858638743456,high_precision
Restrictive,RecentActivity,{'max_recent_floods': 0},1.0,0.2,0.3,4,3,0.4,183,107,76,4,28,25,54,7,69,53,0.8852459016393442,0.5046728971962616,0.6428571428571428,0.6721311475409836,high_precision
Restrictive,RecentActivity,{'max_recent_floods': 0},1.0,0.2,0.5,4,3,0.4,145,79,66,4,28,25,54,20,46,25,0.7297297297297297,0.6835443037974683,0.7058823529411764,0.6896551724137931,high_precision
Restrictive,RecentActivity,{'max_recent_floods': 0},1.0,0.3,0.2,4,3,0.4,191,115,76,4,28,25,36,3,73,79,0.9230769230769231,0.3130434782608696,0.4675324675324676,0.5706806282722513,high_precision
Restrictive,RecentActivity,{'max_recent_floods': 0},1.0,0.3,0.3,4,3,0.4,183,107,76,4,28,25,36,4,72,71,0.9,0.3364485981308411,0.4897959183673469,0.5901639344262295,high_precision
Restrictive,RecentActivity,{'max_recent_floods': 0},1.0,0.3,0.5,4,3,0.4,145,79,66,4,28,25,35,11,55,44,0.7608695652173914,0.4430379746835443,0.5599999999999999,0.6206896551724138,high_precision
Restrictive,RecentActivity,{'max_recent_floods': 0},1.0,0.4,0.2,4,3,0.4,191,115,76,4,28,25,16,1,75,99,0.9411764705882353,0.1391304347826087,0.24242424242424238,0.47643979057591623,high_precision
Restrictive,RecentActivity,{'max_recent_floods': 0},1.0,0.4,0.3,4,3,0.4,183,107,76,4,28,25,19,2,74,88,0.9047619047619048,0.17757009345794392,0.296875,0.5081967213114754,high_precision
Restrictive,RecentActivity,{'max_recent_floods': 0},1.0,0.5,0.2,4,3,0.4,191,115,76,4,28,25,1,0,76,114,1.0,0.008695652173913044,0.017241379310344827,0.4031413612565445,high_precision
Restrictive,RecentActivity,{'max_recent_floods': 0},1.0,0.5,0.3,4,3,0.4,183,107,76,4,28,25,4,1,75,103,0.8,0.037383177570093455,0.07142857142857142,0.43169398907103823,high_precision
Restrictive,RecentActivity,{'max_recent_floods': 0},2.0,0.1,0.2,4,3,0.4,207,115,92,4,28,25,104,26,66,11,0.8,0.9043478260869565,0.8489795918367348,0.821256038647343,high_precision
Restrictive,RecentActivity,{'max_recent_floods': 0},2.0,0.1,0.3,4,3,0.4,199,107,92,4,28,25,99,31,61,8,0.7615384615384615,0.9252336448598131,0.8354430379746836,0.8040201005025126,high_precision
Restrictive,RecentActivity,{'max_recent_floods': 0},2.0,0.2,0.2,4,3,0.4,207,115,92,4,28,25,54,8,84,61,0.8709677419354839,0.46956521739130436,0.6101694915254238,0.6666666666666666,high_precision
Restrictive,RecentActivity,{'max_recent_floods': 0},2.0,0.2,0.3,4,3,0.4,199,107,92,4,28,25,54,11,81,53,0.8307692307692308,0.5046728971962616,0.627906976744186,0.678391959798995,high_precision
Restrictive,RecentActivity,{'max_recent_floods': 0},2.0,0.3,0.2,4,3,0.4,207,115,92,4,28,25,36,5,87,79,0.8780487804878049,0.3130434782608696,0.4615384615384615,0.5942028985507246,high_precision
Restrictive,RecentActivity,{'max_recent_floods': 0},2.0,0.3,0.3,4,3,0.4,199,107,92,4,28,25,36,6,86,71,0.8571428571428571,0.3364485981308411,0.4832214765100671,0.6130653266331658,high_precision
Restrictive,RecentActivity,{'max_recent_floods': 0},2.0,0.3,0.5,4,3,0.4,171,79,92,4,28,25,35,15,77,44,0.7,0.4430379746835443,0.5426356589147288,0.6549707602339181,high_precision
Restrictive,RecentActivity,{'max_recent_floods': 0},2.0,0.4,0.2,4,3,0.4,207,115,92,4,28,25,16,1,91,99,0.9411764705882353,0.1391304347826087,0.24242424242424238,0.5169082125603864,high_precision
Restrictive,RecentActivity,{'max_recent_floods': 0},2.0,0.4,0.3,4,3,0.4,199,107,92,4,28,25,19,2,90,88,0.9047619047619048,0.17757009345794392,0.296875,0.5477386934673367,high_precision
Restrictive,RecentActivity,{'max_recent_floods': 0},2.0,0.5,0.2,4,3,0.4,207,115,92,4,28,25,1,0,92,114,1.0,0.008695652173913044,0.017241379310344827,0.4492753623188406,high_precision
Restrictive,RecentActivity,{'max_recent_floods': 0},2.0,0.5,0.3,4,3,0.4,199,107,92,4,28,25,4,1,91,103,0.8,0.037383177570093455,0.07142857142857142,0.47738693467336685,high_precision
Restrictive,RecentActivity,{'max_recent_floods': 1},1.0,0.1,0.2,4,3,0.4,226,115,111,11,28,25,104,35,76,11,0.7482014388489209,0.9043478260869565,0.8188976377952757,0.7964601769911505,high_precision
Restrictive,RecentActivity,{'max_recent_floods': 1},1.0,0.1,0.3,4,3,0.4,212,107,105,11,28,25,99,37,68,8,0.7279411764705882,0.9252336448598131,0.8148148148148148,0.7877358490566038,high_precision
Restrictive,RecentActivity,{'max_recent_floods': 1},1.0,0.2,0.2,4,3,0.4,226,115,111,11,28,25,54,5,106,61,0.9152542372881356,0.46956521739130436,0.6206896551724138,0.7079646017699115,high_precision
Restrictive,RecentActivity,{'max_recent_floods': 1},1.0,0.2,0.3,4,3,0.4,212,107,105,11,28,25,54,9,96,53,0.8571428571428571,0.5046728971962616,0.6352941176470588,0.7075471698113207,high_precision
Restrictive,RecentActivity,{'max_recent_floods': 1},1.0,0.2,0.5,4,3,0.4,158,79,79,11,28,25,54,20,59,25,0.7297297297297297,0.6835443037974683,0.7058823529411764,0.7151898734177216,high_precision
Restrictive,RecentActivity,{'max_recent_floods': 1},1.0,0.3,0.2,4,3,0.4,226,115,111,11,28,25,36,4,107,79,0.9,0.3130434782608696,0.4645161290322581,0.6327433628318584,high_precision
Restrictive,RecentActivity,{'max_recent_floods': 1},1.0,0.3,0.3,4,3,0.4,212,107,105,11,28,25,36,6,99,71,0.8571428571428571,0.3364485981308411,0.4832214765100671,0.6367924528301887,high_precision
Restrictive,RecentActivity,{'max_recent_floods': 1},1.0,0.3,0.5,4,3,0.4,158,79,79,11,28,25,35,12,67,44,0.7446808510638298,0.4430379746835443,0.5555555555555555,0.6455696202531646,high_precision
Restrictive,RecentActivity,{'max_recent_floods': 1},1.0,0.4,0.2,4,3,0.4,226,115,111,11,28,25,16,1,110,99,0.9411764705882353,0.1391304347826087,0.24242424242424238,0.5575221238938053,high_precision
Restrictive,RecentActivity,{'max_recent_floods': 1},1.0,0.4,0.3,4,3,0.4,212,107,105,11,28,25,19,3,102,88,0.8636363636363636,0.17757009345794392,0.2945736434108527,0.5707547169811321,high_precision
Restrictive,RecentActivity,{'max_recent_floods': 1},1.0,0.4,0.5,4,3,0.4,158,79,79,11,28,25,20,8,71,59,0.7142857142857143,0.25316455696202533,0.3738317757009346,0.5759493670886076,high_precision
Restrictive,RecentActivity,{'max_recent_floods': 1},1.0,0.5,0.2,4,3,0.4,226,115,111,11,28,25,1,0,111,114,1.0,0.008695652173913044,0.017241379310344827,0.49557522123893805,high_precision
Restrictive,RecentActivity,{'max_recent_floods': 1},2.0,0.2,0.2,4,3,0.4,291,115,176,11,28,25,54,10,166,61,0.84375,0.46956521739130436,0.6033519553072626,0.7560137457044673,high_precision
Restrictive,RecentActivity,{'max_recent_floods': 1},2.0,0.2,0.3,4,3,0.4,282,107,175,11,28,25,54,18,157,53,0.75,0.5046728971962616,0.6033519553072626,0.74822695035461,high_precision
Restrictive,RecentActivity,{'max_recent_floods': 1},2.0,0.3,0.2,4,3,0.4,291,115,176,11,28,25,36,7,169,79,0.8372093023255814,0.3130434782608696,0.4556962025316456,0.7044673539518901,high_precision
Restrictive,RecentActivity,{'max_recent_floods': 1},2.0,0.3,0.3,4,3,0.4,282,107,175,11,28,25,36,9,166,71,0.8,0.3364485981308411,0.47368421052631576,0.7163120567375887,high_precision
Restrictive,RecentActivity,{'max_recent_floods': 1},2.0,0.4,0.2,4,3,0.4,291,115,176,11,28,25,16,1,175,99,0.9411764705882353,0.1391304347826087,0.24242424242424238,0.6563573883161512,high_precision
Restrictive,RecentActivity,{'max_recent_floods': 1},2.0,0.4,0.3,4,3,0.4,282,107,175,11,28,25,19,4,171,88,0.8260869565217391,0.17757009345794392,0.2923076923076923,0.6737588652482269,high_precision
Restrictive,RecentActivity,{'max_recent_floods': 1},2.0,0.5,0.2,4,3,0.4,291,115,176,11,28,25,1,0,176,114,1.0,0.008695652173913044,0.017241379310344827,0.6082474226804123,high_precision
Restrictive,RecentActivity,{'max_recent_floods': 2},1.0,0.1,0.2,4,3,0.4,230,115,115,16,28,25,104,37,78,11,0.7375886524822695,0.9043478260869565,0.8125,0.7913043478260869,high_precision
Restrictive,RecentActivity,{'max_recent_floods': 2},1.0,0.1,0.3,4,3,0.4,214,107,107,16,28,25,99,37,70,8,0.7279411764705882,0.9252336448598131,0.8148148148148148,0.7897196261682243,high_precision
Restrictive,RecentActivity,{'max_recent_floods': 2},1.0,0.2,0.2,4,3,0.4,230,115,115,16,28,25,54,7,108,61,0.8852459016393442,0.46956521739130436,0.6136363636363635,0.7043478260869566,high_precision
Restrictive,RecentActivity,{'max_recent_floods': 2},1.0,0.2,0.3,4,3,0.4,214,107,107,16,28,25,54,9,98,53,0.8571428571428571,0.5046728971962616,0.6352941176470588,0.7102803738317757,high_precision
Restrictive,RecentActivity,{'max_recent_floods': 2},1.0,0.2,0.5,4,3,0.4,158,79,79,16,28,25,54,18,61,25,0.75,0.6835443037974683,0.7152317880794701,0.7278481012658228,high_precision
Restrictive,RecentActivity,{'max_recent_floods': 2},1.0,0.3,0.2,4,3,0.4,230,115,115,16,28,25,36,4,111,79,0.9,0.3130434782608696,0.4645161290322581,0.6391304347826087,high_precision
Restrictive,RecentActivity,{'max_recent_floods': 2},1.0,0.3,0.3,4,3,0.4,214,107,107,16,28,25,36,5,102,71,0.8780487804878049,0.3364485981308411,0.4864864864864865,0.6448598130841121,high_precision
Restrictive,RecentActivity,{'max_recent_floods': 2},1.0,0.3,0.5,4,3,0.4,158,79,79,16,28,25,35,11,68,44,0.7608695652173914,0.4430379746835443,0.5599999999999999,0.6518987341772152,high_precision
Restrictive,RecentActivity,{'max_recent_floods': 2},1.0,0.4,0.2,4,3,0.4,230,115,115,16,28,25,16,1,114,99,0.9411764705882353,0.1391304347826087,0.24242424242424238,0.5652173913043478,high_precision
Restrictive,RecentActivity,{'max_recent_floods': 2},1.0,0.4,0.3,4,3,0.4,214,107,107,16,28,25,19,2,105,88,0.9047619047619048,0.17757009345794392,0.296875,0.5794392523364486,high_precision
Restrictive,RecentActivity,{'max_recent_floods': 2},1.0,0.4,0.5,4,3,0.4,158,79,79,16,28,25,20,8,71,59,0.7142857142857143,0.25316455696202533,0.3738317757009346,0.5759493670886076,high_precision
Restrictive,RecentActivity,{'max_recent_floods': 2},1.0,0.5,0.2,4,3,0.4,230,115,115,16,28,25,1,0,115,114,1.0,0.008695652173913044,0.017241379310344827,0.5043478260869565,high_precision
Restrictive,RecentActivity,{'max_recent_floods': 2},2.0,0.2,0.2,4,3,0.4,311,115,196,16,28,25,54,14,182,61,0.7941176470588235,0.46956521739130436,0.5901639344262295,0.7588424437299035,high_precision
Restrictive,RecentActivity,{'max_recent_floods': 2},2.0,0.2,0.3,4,3,0.4,298,107,191,16,28,25,54,20,171,53,0.7297297297297297,0.5046728971962616,0.5966850828729281,0.7550335570469798,high_precision
Restrictive,RecentActivity,{'max_recent_floods': 2},2.0,0.3,0.2,4,3,0.4,311,115,196,16,28,25,36,6,190,79,0.8571428571428571,0.3130434782608696,0.4585987261146497,0.7266881028938906,high_precision
Restrictive,RecentActivity,{'max_recent_floods': 2},2.0,0.3,0.3,4,3,0.4,298,107,191,16,28,25,36,10,181,71,0.782608695652174,0.3364485981308411,0.47058823529411764,0.7281879194630873,high_precision
Restrictive,RecentActivity,{'max_recent_floods': 2},2.0,0.4,0.2,4,3,0.4,311,115,196,16,28,25,16,1,195,99,0.9411764705882353,0.1391304347826087,0.24242424242424238,0.6784565916398714,high_precision
Restrictive,RecentActivity,{'max_recent_floods': 2},2.0,0.4,0.3,4,3,0.4,298,107,191,16,28,25,19,6,185,88,0.76,0.17757009345794392,0.2878787878787879,0.6845637583892618,high_precision
Restrictive,RecentActivity,{'max_recent_floods': 2},2.0,0.5,0.2,4,3,0.4,311,115,196,16,28,25,1,0,196,114,1.0,0.008695652173913044,0.017241379310344827,0.6334405144694534,high_precision
